TAG	TEXT	COMMENT	AUDIOFILE
GAMEPLAY_EMOTE_EX1_323h_CONCEDE	Ihr gewinnt ... ABER EURE WELT IST IMMER NOCH DEM UNTERGANG GEWEIHT.		
GAMEPLAY_EMOTE_EX1_323h_ERROR_FULL_MINIONS	ZU VIELE DIENER!		
GAMEPLAY_EMOTE_EX1_323h_ERROR_GENERIC	DAS KANN ICH NICHT TUN!		
GAMEPLAY_EMOTE_EX1_323h_ERROR_HAND_FULL	ZU VIELE KARTEN!		
GAMEPLAY_EMOTE_EX1_323h_ERROR_I_ATTACKED	ICH HABE BEREITS ANGEGRIFFEN!		
GAMEPLAY_EMOTE_EX1_323h_ERROR_JUST_PLAYED	DER DIENER IST DOCH GERADE ERST INS SPIEL GEKOMMEN!		
GAMEPLAY_EMOTE_EX1_323h_ERROR_MINION_ATTACKED	DAS DING HAT BEREITS ANGEGRIFFEN!		
GAMEPLAY_EMOTE_EX1_323h_ERROR_NEED_MANA	NICHT GENUG MANA!		
GAMEPLAY_EMOTE_EX1_323h_ERROR_NEED_WEAPON	WO IST MEINE WAFFE HIN?		
GAMEPLAY_EMOTE_EX1_323h_ERROR_PLAY	DAS KANN ICH NICHT SPIELEN!		
GAMEPLAY_EMOTE_EX1_323h_ERROR_STEALTH	VERSTOHLEN!		
GAMEPLAY_EMOTE_EX1_323h_ERROR_TARGET	UNGÜLTIG!		
GAMEPLAY_EMOTE_EX1_323h_ERROR_TAUNT	DER VERSPOTTENDE DIENER IST MIR IM WEG!		
GAMEPLAY_EMOTE_EX1_323h_GOOD_GAME	GUTES SPIEL!		
GAMEPLAY_EMOTE_EX1_323h_GREETINGS	Ihr steht vor JARAXXUS, Eredarlord der BRENNENDEN LEGION!		
GAMEPLAY_EMOTE_EX1_323h_LOW_CARDS	Mein Deck hat bald KEINE KARTEN MEHR!		
GAMEPLAY_EMOTE_EX1_323h_LUNAR_NEW_YEAR	Ihr steht vor JARAXXUS, Eredarlord der BRENNENDEN LEGION!		
GAMEPLAY_EMOTE_EX1_323h_NO_CARDS	NEEIIN! ICH HABE KEINE KARTEN MEHR!		
GAMEPLAY_EMOTE_EX1_323h_OOPS	FEHLER!		
GAMEPLAY_EMOTE_EX1_323h_SORRY	JARAXXUS IST ... zutiefst betrübt.		
GAMEPLAY_EMOTE_EX1_323h_THANKS	DANKE!		
GAMEPLAY_EMOTE_EX1_323h_THINK1	Hmm ...		
GAMEPLAY_EMOTE_EX1_323h_THINK2	Ich frage mich, ob ...		
GAMEPLAY_EMOTE_EX1_323h_THINK3	Wie soll ich Euch vernichten ...		
GAMEPLAY_EMOTE_EX1_323h_THREATEN	AUSLÖSCHUNG!		
GAMEPLAY_EMOTE_EX1_323h_TIMER	DIE ZEIT LÄUFT DAVON.		
GAMEPLAY_EMOTE_EX1_323h_WELL_PLAYED	GUT GESPIELT!		
GAMEPLAY_EMOTE_EX1_323h_WINTERVEIL_GREETINGS	DIESES WINTERHAUCHFEST WERDE ICH EURE SEELE UNTER DEM BAUM FINDEN!		
GAMEPLAY_EMOTE_EX1_323h_WOW_04	UNGLAUBLICH!		
GAMEPLAY_EMOTE_HERO_01_CONCEDE	Ich wähle den Tod!		
GAMEPLAY_EMOTE_HERO_01_ERROR_FULL_MINIONS	Ich habe zu viele Diener.		
GAMEPLAY_EMOTE_HERO_01_ERROR_GENERIC	Das kann ich nicht tun.		
GAMEPLAY_EMOTE_HERO_01_ERROR_HAND_FULL	Meine Hand ist zu voll.		
GAMEPLAY_EMOTE_HERO_01_ERROR_I_ATTACKED	Ich habe bereits angegriffen.		
GAMEPLAY_EMOTE_HERO_01_ERROR_JUST_PLAYED	Dieser Diener wird in der nächsten Runde bereit sein.		
GAMEPLAY_EMOTE_HERO_01_ERROR_MINION_ATTACKED	Dieser Diener hat bereits angegriffen.		
GAMEPLAY_EMOTE_HERO_01_ERROR_NEED_MANA	Ich habe nicht genug Mana.		
GAMEPLAY_EMOTE_HERO_01_ERROR_NEED_WEAPON	Ich brauche eine Waffe.		
GAMEPLAY_EMOTE_HERO_01_ERROR_PLAY	Diese Aktion kann ich nicht ausführen.		
GAMEPLAY_EMOTE_HERO_01_ERROR_STEALTH	Ich kann verstohlene Diener nicht als Ziel wählen.		
GAMEPLAY_EMOTE_HERO_01_ERROR_TARGET	Das ist kein gültiges Ziel.		
GAMEPLAY_EMOTE_HERO_01_ERROR_TAUNT	Ein Diener mit Spott ist im Weg.		
GAMEPLAY_EMOTE_HERO_01_EVENT_LUNAR_NEW_YEAR	Heh, Grüße_...		
GAMEPLAY_EMOTE_HERO_01_GOOD_GAME	Gutes Spiel!		
GAMEPLAY_EMOTE_HERO_01_GREETINGS	Heh, Grüße_...		
GAMEPLAY_EMOTE_HERO_01_LOW_CARDS	Ich habe fast keine Karten mehr.		
GAMEPLAY_EMOTE_HERO_01_MIRROR_START	Hahaha! Zeigt, was Ihr drauf habt!		
GAMEPLAY_EMOTE_HERO_01_NO_CARDS	Ich habe keine Karten mehr!		
GAMEPLAY_EMOTE_HERO_01_OOPS	Das war ein Fehler.		
GAMEPLAY_EMOTE_HERO_01_SORRY	Das ist bedauerlich.		
GAMEPLAY_EMOTE_HERO_01_START	Sieg oder Tod!		
GAMEPLAY_EMOTE_HERO_01_THANKS	Danke.		
GAMEPLAY_EMOTE_HERO_01_THINK1	Hmm ...		
GAMEPLAY_EMOTE_HERO_01_THINK2	Hmm, ich frage mich, ob ...		
GAMEPLAY_EMOTE_HERO_01_THINK3	Was jetzt ...		
GAMEPLAY_EMOTE_HERO_01_THREATEN	ICH WERDE EUCH VERNICHTEN!		
GAMEPLAY_EMOTE_HERO_01_TIMER	Ich muss mich entscheiden!		
GAMEPLAY_EMOTE_HERO_01_WELL_PLAYED	Gut gespielt.		
GAMEPLAY_EMOTE_HERO_01_WINTERVEIL_GREETINGS	Frohes Winterhauchfest!		
GAMEPLAY_EMOTE_HERO_01_WOW	Beeindruckend!		
GAMEPLAY_EMOTE_HERO_01A_CONCEDE	Oh, Ihr habt mich erwischt!		
GAMEPLAY_EMOTE_HERO_01A_ERROR_FULL_MINIONS	Ich habe zu viele Diener.		
GAMEPLAY_EMOTE_HERO_01A_ERROR_GENERIC	Das kann ich nicht tun.		
GAMEPLAY_EMOTE_HERO_01A_ERROR_HAND_FULL	Meine Hand ist zu voll.		
GAMEPLAY_EMOTE_HERO_01A_ERROR_I_ATTACKED	Ich habe bereits angegriffen.		
GAMEPLAY_EMOTE_HERO_01A_ERROR_JUST_PLAYED	Dieser Diener wird in der nächsten Runde bereit sein.		
GAMEPLAY_EMOTE_HERO_01A_ERROR_MINION_ATTACKED	Dieser Diener hat bereits angegriffen.		
GAMEPLAY_EMOTE_HERO_01A_ERROR_NEED_MANA	Ich habe nicht genug Mana.		
GAMEPLAY_EMOTE_HERO_01A_ERROR_NEED_WEAPON	Ich brauche eine Waffe.		
GAMEPLAY_EMOTE_HERO_01A_ERROR_PLAY	Diese Aktion kann ich nicht ausführen.		
GAMEPLAY_EMOTE_HERO_01A_ERROR_STEALTH	Ich kann verstohlene Diener nicht als Ziel wählen.		
GAMEPLAY_EMOTE_HERO_01A_ERROR_TARGET	Das ist kein gültiges Ziel.		
GAMEPLAY_EMOTE_HERO_01A_ERROR_TAUNT	Ich muss den Diener mit Spott angreifen.		
GAMEPLAY_EMOTE_HERO_01A_EVENT_LUNAR_NEW_YEAR	Heh, Grüße ...		
GAMEPLAY_EMOTE_HERO_01A_GOOD_GAME	Gutes Spiel!		
GAMEPLAY_EMOTE_HERO_01A_GREETINGS	Seid gegrüßt.		
GAMEPLAY_EMOTE_HERO_01A_LOW_CARDS	Ich hab fast keine Karten mehr.		
GAMEPLAY_EMOTE_HERO_01A_MIRROR_START	Jawohl, für Khaz Modan!		
GAMEPLAY_EMOTE_HERO_01A_NO_CARDS	Ich habe keine Karten mehr!		
GAMEPLAY_EMOTE_HERO_01A_OOPS	Das war ... nicht so gut.		
GAMEPLAY_EMOTE_HERO_01A_SORRY	Oh, das tut mir leid, Freund.		
GAMEPLAY_EMOTE_HERO_01A_START	Für Khaz Modan!		
GAMEPLAY_EMOTE_HERO_01A_THANKS	Oh, ich danke Euch.		
GAMEPLAY_EMOTE_HERO_01A_THINK1	Hmmm…		
GAMEPLAY_EMOTE_HERO_01A_THINK2	Soll ich ...? Hm, nein, nein ...		
GAMEPLAY_EMOTE_HERO_01A_THINK3	So viele Möglichkeiten …		
GAMEPLAY_EMOTE_HERO_01A_THREATEN	Spürt den Furor des Berges!		
GAMEPLAY_EMOTE_HERO_01A_TIMER	Ah! Ich muss mich beeilen!		
GAMEPLAY_EMOTE_HERO_01A_WELL_PLAYED	Gut gespielt.		
GAMEPLAY_EMOTE_HERO_01A_WINTERVEIL_GREETINGS	Fröhliches Winterhauchfest!		
GAMEPLAY_EMOTE_HERO_01A_WOW	Beim Barte meiner Mutter!		
GAMEPLAY_EMOTE_HERO_02_CONCEDE	Diese Runde geht an Euch.		
GAMEPLAY_EMOTE_HERO_02_ERROR_FULL_MINIONS	Ich habe zu viele Diener.		
GAMEPLAY_EMOTE_HERO_02_ERROR_GENERIC	Das kann ich nicht tun.		
GAMEPLAY_EMOTE_HERO_02_ERROR_HAND_FULL	Meine Hand ist zu voll.		
GAMEPLAY_EMOTE_HERO_02_ERROR_I_ATTACKED	Ich habe bereits angegriffen.		
GAMEPLAY_EMOTE_HERO_02_ERROR_JUST_PLAYED	Dieser Diener wird in der nächsten Runde bereit sein.		
GAMEPLAY_EMOTE_HERO_02_ERROR_MINION_ATTACKED	Dieser Diener hat bereits angegriffen.		
GAMEPLAY_EMOTE_HERO_02_ERROR_NEED_MANA	Ich habe nicht genug Mana.		
GAMEPLAY_EMOTE_HERO_02_ERROR_NEED_WEAPON	Ich brauche eine Waffe.		
GAMEPLAY_EMOTE_HERO_02_ERROR_PLAY	Diese Aktion kann ich nicht ausführen.		
GAMEPLAY_EMOTE_HERO_02_ERROR_STEALTH	Ich kann verstohlene Diener nicht als Ziel wählen.		
GAMEPLAY_EMOTE_HERO_02_ERROR_TARGET	Das ist kein gültiges Ziel.		
GAMEPLAY_EMOTE_HERO_02_ERROR_TAUNT	Ein Diener mit Spott ist im Weg.		
GAMEPLAY_EMOTE_HERO_02_EVENT_LUNAR_NEW_YEAR	Grüße!		
GAMEPLAY_EMOTE_HERO_02_GOOD_GAME	Gutes Spiel!		
GAMEPLAY_EMOTE_HERO_02_GREETINGS	Grüße!		
GAMEPLAY_EMOTE_HERO_02_LOW_CARDS	Ich habe fast keine Karten mehr.		
GAMEPLAY_EMOTE_HERO_02_MIRROR_START	Für die Frostwölfe!		
GAMEPLAY_EMOTE_HERO_02_NO_CARDS	Ich habe keine Karten mehr!		
GAMEPLAY_EMOTE_HERO_02_OOPS	Das war ein Fehler!		
GAMEPLAY_EMOTE_HERO_02_SORRY	Es tut mir leid, dass das geschehen ist.		
GAMEPLAY_EMOTE_HERO_02_START	Eure Zeit ist gekommen!		
GAMEPLAY_EMOTE_HERO_02_THANKS	Ich danke Euch.		
GAMEPLAY_EMOTE_HERO_02_THINK1	Hmm ...		
GAMEPLAY_EMOTE_HERO_02_THINK2	Ich frage mich, ob ...		
GAMEPLAY_EMOTE_HERO_02_THINK3	Hmm, was tun, was tun ...		
GAMEPLAY_EMOTE_HERO_02_THREATEN	Die Elemente werden Euch vernichten!		
GAMEPLAY_EMOTE_HERO_02_TIMER	Es bleibt nicht viel Zeit!		
GAMEPLAY_EMOTE_HERO_02_WELL_PLAYED	Gut gespielt.		
GAMEPLAY_EMOTE_HERO_02_WINTERVEIL_GREETINGS	Ein frohes Winterhauchfest wünsche ich Euch!		
GAMEPLAY_EMOTE_HERO_02_WOW	Das ist unglaublich!		
GAMEPLAY_EMOTE_HERO_02A_CONCEDE	<Ich gebe mich\ngeschlagen.>		
GAMEPLAY_EMOTE_HERO_02A_ERROR_FULL_MINIONS	<Ich habe zu\nviele Diener.>		
GAMEPLAY_EMOTE_HERO_02A_ERROR_GENERIC	<Das ist nicht\nmöglich.>		
GAMEPLAY_EMOTE_HERO_02A_ERROR_HAND_FULL	<Meine Hand\nist zu voll.>		
GAMEPLAY_EMOTE_HERO_02A_ERROR_I_ATTACKED	<Ich habe bereits\nangegriffen.>	VO_HERO_15_ERROR04_43.wav	
GAMEPLAY_EMOTE_HERO_02A_ERROR_JUST_PLAYED	<Dieser Diener\nbraucht noch\neinen Moment.>		
GAMEPLAY_EMOTE_HERO_02A_ERROR_MINION_ATTACKED	<Dieser Diener\nhat bereits\nangegriffen.>		
GAMEPLAY_EMOTE_HERO_02A_ERROR_NEED_MANA	<Ich brauche\nmehr Mana.>		
GAMEPLAY_EMOTE_HERO_02A_ERROR_NEED_WEAPON	<Ich brauche\neine Waffe.>		
GAMEPLAY_EMOTE_HERO_02A_ERROR_PLAY	<Diese Aktion\nkann ich nicht\nausführen.>		
GAMEPLAY_EMOTE_HERO_02A_ERROR_STEALTH	<Ich kann verstohlene\nDiener nicht als Ziel\nwählen.>		
GAMEPLAY_EMOTE_HERO_02A_ERROR_TARGET	<Dieses Ziel\nist ungültig.>		
GAMEPLAY_EMOTE_HERO_02A_ERROR_TAUNT	<Ich muss den\nDiener mit Spott\nangreifen.>		
GAMEPLAY_EMOTE_HERO_02A_EVENT_LUNAR_NEW_YEAR	<Viel Erfolg\nim neuen Jahr!>		
GAMEPLAY_EMOTE_HERO_02A_GREETINGS	<Hallo, Freund.>		
GAMEPLAY_EMOTE_HERO_02A_LOW_CARDS	<Ich habe\nfast keine\nKarten mehr!>		
GAMEPLAY_EMOTE_HERO_02A_MIRROR_START	<Jung!? Ihr\nhabt noch viel\nzu lernen.>		
GAMEPLAY_EMOTE_HERO_02A_NO_CARDS	<Ich habe keine\nKarten mehr!>		
GAMEPLAY_EMOTE_HERO_02A_OOPS	<Verflixt!>		
GAMEPLAY_EMOTE_HERO_02A_SORRY	<Entschuldigt,\njunges Wesen.>		
GAMEPLAY_EMOTE_HERO_02A_START	<Jetzt werdet Ihr\nEure Lektion lernen,\njunges Wesen!>		
GAMEPLAY_EMOTE_HERO_02A_THANKS	<Ich danke Euch\naus tiefstem\nHerzen.>		
GAMEPLAY_EMOTE_HERO_02A_THINK1	<Soll ich_...>	VO_HERO_15_Thinking1_13.wav	
GAMEPLAY_EMOTE_HERO_02A_THINK2	<Eine\ninteressante\nIdee_...>		
GAMEPLAY_EMOTE_HERO_02A_THINK3	<Eine\nMöglichkeit_...>		
GAMEPLAY_EMOTE_HERO_02A_THREATEN	<Ihr nehmt es\nmit der Weisheit\nder Meere auf!>		
GAMEPLAY_EMOTE_HERO_02A_TIMER	<Jetzt aber\nzügig!>		
GAMEPLAY_EMOTE_HERO_02A_WELL_PLAYED	<Gut gespielt.>		
GAMEPLAY_EMOTE_HERO_02A_WINTERVEIL_GREETINGS	<Frohes\nWinterhauchfest!>		
GAMEPLAY_EMOTE_HERO_02A_WOW	<Unfassbar!>		
GAMEPLAY_EMOTE_HERO_03_CONCEDE	Ich gebe auf.		
GAMEPLAY_EMOTE_HERO_03_ERROR_FULL_MINIONS	Ich habe zu viele Diener.		
GAMEPLAY_EMOTE_HERO_03_ERROR_GENERIC	Das kann ich nicht tun.		
GAMEPLAY_EMOTE_HERO_03_ERROR_HAND_FULL	Meine Hand ist zu voll.		
GAMEPLAY_EMOTE_HERO_03_ERROR_I_ATTACKED	Ich habe bereits angegriffen.		
GAMEPLAY_EMOTE_HERO_03_ERROR_JUST_PLAYED	Dieser Diener wird in der nächsten Runde bereit sein.		
GAMEPLAY_EMOTE_HERO_03_ERROR_MINION_ATTACKED	Dieser Diener hat bereits angegriffen.		
GAMEPLAY_EMOTE_HERO_03_ERROR_NEED_MANA	Ich habe nicht genug Mana.		
GAMEPLAY_EMOTE_HERO_03_ERROR_NEED_WEAPON	Ich brauche eine Waffe.		
GAMEPLAY_EMOTE_HERO_03_ERROR_PLAY	Diese Aktion kann ich nicht ausführen.		
GAMEPLAY_EMOTE_HERO_03_ERROR_STEALTH	Ich kann verstohlene Diener nicht als Ziel wählen.		
GAMEPLAY_EMOTE_HERO_03_ERROR_TARGET	Das ist kein gültiges Ziel.		
GAMEPLAY_EMOTE_HERO_03_ERROR_TAUNT	Ein Diener mit Spott ist im Weg.		
GAMEPLAY_EMOTE_HERO_03_EVENT_LUNAR_NEW_YEAR	Die Freude ist ganz meinerseits.		
GAMEPLAY_EMOTE_HERO_03_GOOD_GAME	Gutes Spiel!		
GAMEPLAY_EMOTE_HERO_03_GREETINGS	Die Freude ist ganz meinerseits.		
GAMEPLAY_EMOTE_HERO_03_LOW_CARDS	Ich habe fast keine Karten mehr.		
GAMEPLAY_EMOTE_HERO_03_MIRROR_START	Das müsst Ihr mir nicht sagen.		
GAMEPLAY_EMOTE_HERO_03_NO_CARDS	Ich habe keine Karten mehr!		
GAMEPLAY_EMOTE_HERO_03_OOPS	Fehler wurden begangen ...		
GAMEPLAY_EMOTE_HERO_03_SORRY	Oh, Entschuldigung.		
GAMEPLAY_EMOTE_HERO_03_START	Seid auf der Hut.		
GAMEPLAY_EMOTE_HERO_03_THANKS	Danke.		
GAMEPLAY_EMOTE_HERO_03_THINK1	Hmm ...		
GAMEPLAY_EMOTE_HERO_03_THINK2	Ich frage mich, ob ...		
GAMEPLAY_EMOTE_HERO_03_THINK3	So viele Möglichkeiten ...		
GAMEPLAY_EMOTE_HERO_03_THREATEN	Ich werde Euer Tod sein!		
GAMEPLAY_EMOTE_HERO_03_TIMER	Ich muss mich bald entscheiden ...		
GAMEPLAY_EMOTE_HERO_03_WELL_PLAYED	Gut gespielt.		
GAMEPLAY_EMOTE_HERO_03_WINTERVEIL_GREETINGS	Frohes Winterhauchfest!		
GAMEPLAY_EMOTE_HERO_03_WOW	Wahnsinn!		
GAMEPLAY_EMOTE_HERO_04_CONCEDE	Der Sieg gehört Euch.		
GAMEPLAY_EMOTE_HERO_04_ERROR_FULL_MINIONS	Ich habe zu viele Diener.		
GAMEPLAY_EMOTE_HERO_04_ERROR_GENERIC	Das kann ich nicht tun.		
GAMEPLAY_EMOTE_HERO_04_ERROR_HAND_FULL	Meine Hand ist zu voll.		
GAMEPLAY_EMOTE_HERO_04_ERROR_I_ATTACKED	Ich habe bereits angegriffen.		
GAMEPLAY_EMOTE_HERO_04_ERROR_JUST_PLAYED	Dieser Diener wird in der nächsten Runde bereit sein.		
GAMEPLAY_EMOTE_HERO_04_ERROR_MINION_ATTACKED	Dieser Diener hat bereits angegriffen.		
GAMEPLAY_EMOTE_HERO_04_ERROR_NEED_MANA	Ich habe nicht genug Mana.		
GAMEPLAY_EMOTE_HERO_04_ERROR_NEED_WEAPON	Ich brauche eine Waffe.		
GAMEPLAY_EMOTE_HERO_04_ERROR_PLAY	Diese Aktion kann ich nicht ausführen.		
GAMEPLAY_EMOTE_HERO_04_ERROR_STEALTH	Ich kann verstohlene Diener nicht als Ziel wählen.		
GAMEPLAY_EMOTE_HERO_04_ERROR_TARGET	Das ist kein gültiges Ziel.		
GAMEPLAY_EMOTE_HERO_04_ERROR_TAUNT	Ein Diener mit Spott ist im Weg.		
GAMEPLAY_EMOTE_HERO_04_EVENT_LUNAR_NEW_YEAR	Ich grüße Euch!		
GAMEPLAY_EMOTE_HERO_04_GOOD_GAME	Gutes Spiel!		
GAMEPLAY_EMOTE_HERO_04_GREETINGS	Ich grüße Euch!		
GAMEPLAY_EMOTE_HERO_04_LOW_CARDS	Ich habe fast keine Karten mehr.		
GAMEPLAY_EMOTE_HERO_04_MIRROR_START	Das Licht gehorcht mir!		
GAMEPLAY_EMOTE_HERO_04_NO_CARDS	Ich habe keine Karten mehr!		
GAMEPLAY_EMOTE_HERO_04_OOPS	Das war ein Fehler.		
GAMEPLAY_EMOTE_HERO_04_SORRY	Es tut mir leid.		
GAMEPLAY_EMOTE_HERO_04_START	Ich werde ehrenhaft kämpfen.		
GAMEPLAY_EMOTE_HERO_04_THANKS	Danke.		
GAMEPLAY_EMOTE_HERO_04_THINK1	Hmm ...		
GAMEPLAY_EMOTE_HERO_04_THINK2	Ich frage mich, ob ...		
GAMEPLAY_EMOTE_HERO_04_THINK3	Lasst mich nachdenken ...		
GAMEPLAY_EMOTE_HERO_04_THREATEN	Die Gerechtigkeit verlangt nach Rache!		
GAMEPLAY_EMOTE_HERO_04_TIMER	Ich muss mich beeilen!		
GAMEPLAY_EMOTE_HERO_04_WELL_PLAYED	Gut gespielt.		
GAMEPLAY_EMOTE_HERO_04_WINTERVEIL_GREETINGS	Frohes Winterhauchfest, Champion!		
GAMEPLAY_EMOTE_HERO_04_WOW	Beim Heiligen Licht!		
GAMEPLAY_EMOTE_HERO_04A_CONCEDE	Der Sieg ist Euer. Ich ergebe mich.		
GAMEPLAY_EMOTE_HERO_04A_ERROR_FULL_MINIONS	Ich habe zu viele Diener.		
GAMEPLAY_EMOTE_HERO_04A_ERROR_GENERIC	Das kann ich nicht tun.		
GAMEPLAY_EMOTE_HERO_04A_ERROR_HAND_FULL	Meine Hand ist zu voll.		
GAMEPLAY_EMOTE_HERO_04A_ERROR_I_ATTACKED	Ich habe bereits angegriffen.		
GAMEPLAY_EMOTE_HERO_04A_ERROR_JUST_PLAYED	Dieser Diener wird in der nächsten Runde bereit sein.		
GAMEPLAY_EMOTE_HERO_04A_ERROR_MINION_ATTACKED	Dieser Diener hat bereits angegriffen.		
GAMEPLAY_EMOTE_HERO_04A_ERROR_NEED_MANA	Ich habe nicht genug Mana.		
GAMEPLAY_EMOTE_HERO_04A_ERROR_NEED_WEAPON	Ich brauche eine Waffe.		
GAMEPLAY_EMOTE_HERO_04A_ERROR_PLAY	Diese Aktion kann ich nicht ausführen.		
GAMEPLAY_EMOTE_HERO_04A_ERROR_STEALTH	Ich kann verstohlene Diener nicht als Ziel wählen.		
GAMEPLAY_EMOTE_HERO_04A_ERROR_TARGET	Das ist kein gültiges Ziel.		
GAMEPLAY_EMOTE_HERO_04A_ERROR_TAUNT	Ich muss den Diener mit Spott angreifen.		
GAMEPLAY_EMOTE_HERO_04A_GOOD_GAME	Gutes Spiel!		
GAMEPLAY_EMOTE_HERO_04A_GREETINGS	Ah! Hallo.		
GAMEPLAY_EMOTE_HERO_04A_LOW_CARDS	Ich habe fast keine Karten mehr.		
GAMEPLAY_EMOTE_HERO_04A_LUNAR_NEW_YEAR	Ah! Hallo.		
GAMEPLAY_EMOTE_HERO_04A_MIRROR_START	Genau wie meiner.		
GAMEPLAY_EMOTE_HERO_04A_NO_CARDS	Ich habe keine Karten mehr!		
GAMEPLAY_EMOTE_HERO_04A_OOPS	Das war ein klarer Fehler.		
GAMEPLAY_EMOTE_HERO_04A_SORRY	Oh, Entschuldigung.		
GAMEPLAY_EMOTE_HERO_04A_START	Mein Hammer brennt mit heiligem Feuer!		
GAMEPLAY_EMOTE_HERO_04A_THANKS	Ihr habt meinen aufrichtigen Dank.		
GAMEPLAY_EMOTE_HERO_04A_THINK1	Hmmm…		
GAMEPLAY_EMOTE_HERO_04A_THINK2	Eine schwere Wahl ...		
GAMEPLAY_EMOTE_HERO_04A_THINK3	Soll ich ... hmm...		
GAMEPLAY_EMOTE_HERO_04A_THREATEN	Ihr werdet bezahlen, Abschaum!		
GAMEPLAY_EMOTE_HERO_04A_TIMER	Wir müssen handeln!		
GAMEPLAY_EMOTE_HERO_04A_WELL_PLAYED	Gut gespielt.		
GAMEPLAY_EMOTE_HERO_04A_WINTERVEIL_GREETINGS	Fröhliches Winterhauchfest!		
GAMEPLAY_EMOTE_HERO_04A_WOW	Unfassbar!		
GAMEPLAY_EMOTE_HERO_05_CONCEDE	Gut gekämpft, ich ergebe mich.		
GAMEPLAY_EMOTE_HERO_05_ERROR_FULL_MINIONS	Ich habe zu viele Diener.		
GAMEPLAY_EMOTE_HERO_05_ERROR_GENERIC	Das kann ich nicht tun.		
GAMEPLAY_EMOTE_HERO_05_ERROR_HAND_FULL	Meine Hand ist zu voll.		
GAMEPLAY_EMOTE_HERO_05_ERROR_I_ATTACKED	Ich habe bereits angegriffen.		
GAMEPLAY_EMOTE_HERO_05_ERROR_JUST_PLAYED	Dieser Diener wird in der nächsten Runde bereit sein.		
GAMEPLAY_EMOTE_HERO_05_ERROR_MINION_ATTACKED	Dieser Diener hat bereits angegriffen.		
GAMEPLAY_EMOTE_HERO_05_ERROR_NEED_MANA	Ich habe nicht genug Mana.		
GAMEPLAY_EMOTE_HERO_05_ERROR_NEED_WEAPON	Ich brauche eine Waffe.		
GAMEPLAY_EMOTE_HERO_05_ERROR_PLAY	Diese Aktion kann ich nicht ausführen.		
GAMEPLAY_EMOTE_HERO_05_ERROR_STEALTH	Ich kann verstohlene Diener nicht als Ziel wählen.		
GAMEPLAY_EMOTE_HERO_05_ERROR_TARGET	Das ist kein gültiges Ziel.		
GAMEPLAY_EMOTE_HERO_05_ERROR_TAUNT	Ein Diener mit Spott ist im Weg.		
GAMEPLAY_EMOTE_HERO_05_EVENT_LUNAR_NEW_YEAR	Grüße.		
GAMEPLAY_EMOTE_HERO_05_GOOD_GAME	Gutes Spiel!		
GAMEPLAY_EMOTE_HERO_05_GREETINGS	Grüße.		
GAMEPLAY_EMOTE_HERO_05_LOW_CARDS	Ich habe fast keine Karten mehr.		
GAMEPLAY_EMOTE_HERO_05_MIRROR_START	Nur zu!		
GAMEPLAY_EMOTE_HERO_05_NO_CARDS	Ich habe keine Karten mehr!		
GAMEPLAY_EMOTE_HERO_05_OOPS	Der Schuss ging daneben.		
GAMEPLAY_EMOTE_HERO_05_SORRY	Entschuldigt bitte.		
GAMEPLAY_EMOTE_HERO_05_START	Lasst die Jagd beginnen!		
GAMEPLAY_EMOTE_HERO_05_THANKS	Danke.		
GAMEPLAY_EMOTE_HERO_05_THINK1	Hmm ...		
GAMEPLAY_EMOTE_HERO_05_THINK2	Ich frage mich, ob ...		
GAMEPLAY_EMOTE_HERO_05_THINK3	Hrmmmmm_...		
GAMEPLAY_EMOTE_HERO_05_THREATEN	Ich bringe Euch zur Strecke!		
GAMEPLAY_EMOTE_HERO_05_TIMER	Zeit verfliegt.		
GAMEPLAY_EMOTE_HERO_05_WELL_PLAYED	Gut gespielt.		
GAMEPLAY_EMOTE_HERO_05_WINTERVEIL_GREETINGS	Frohes Winterhauchfest!		
GAMEPLAY_EMOTE_HERO_05_WOW	Erstaunlich!		
GAMEPLAY_EMOTE_HERO_05A_CONCEDE	Meisterhaft! Ich ergebe mich.		
GAMEPLAY_EMOTE_HERO_05A_ERROR_FULL_MINIONS	Ich habe zu viele Diener.		
GAMEPLAY_EMOTE_HERO_05A_ERROR_GENERIC	Das kann ich nicht tun.		
GAMEPLAY_EMOTE_HERO_05A_ERROR_HAND_FULL	Meine Hand ist zu voll.		
GAMEPLAY_EMOTE_HERO_05A_ERROR_I_ATTACKED	Ich habe bereits angegriffen.		
GAMEPLAY_EMOTE_HERO_05A_ERROR_JUST_PLAYED	Dieser Diener wird in der nächsten Runde bereit sein.		
GAMEPLAY_EMOTE_HERO_05A_ERROR_MINION_ATTACKED	Dieser Diener hat bereits angegriffen.		
GAMEPLAY_EMOTE_HERO_05A_ERROR_NEED_MANA	Ich habe nicht genug Mana.		
GAMEPLAY_EMOTE_HERO_05A_ERROR_NEED_WEAPON	Ich brauche eine Waffe.		
GAMEPLAY_EMOTE_HERO_05A_ERROR_PLAY	Diese Aktion kann ich nicht ausführen.		
GAMEPLAY_EMOTE_HERO_05A_ERROR_STEALTH	Ich kann verstohlene Diener nicht als Ziel wählen.		
GAMEPLAY_EMOTE_HERO_05A_ERROR_TARGET	Das ist kein gültiges Ziel.		
GAMEPLAY_EMOTE_HERO_05A_ERROR_TAUNT	Ich muss den Diener mit Spott angreifen.		
GAMEPLAY_EMOTE_HERO_05A_EVENT_LUNAR_NEW_YEAR	Grüße.		
GAMEPLAY_EMOTE_HERO_05A_GOOD_GAME	Gutes Spiel!		
GAMEPLAY_EMOTE_HERO_05A_GREETINGS	Guten Tag.		
GAMEPLAY_EMOTE_HERO_05A_LOW_CARDS	Ich habe fast keine Karten mehr.		
GAMEPLAY_EMOTE_HERO_05A_MIRROR_START	Ich zittere nie.		
GAMEPLAY_EMOTE_HERO_05A_NO_CARDS	Ich habe keine Karten mehr!		
GAMEPLAY_EMOTE_HERO_05A_OOPS	Hm, ein Fehler.		
GAMEPLAY_EMOTE_HERO_05A_SORRY	Das bedauere ich.		
GAMEPLAY_EMOTE_HERO_05A_START	Zittert vor der Macht der Elfen!		
GAMEPLAY_EMOTE_HERO_05A_THANKS	Danke.		
GAMEPLAY_EMOTE_HERO_05A_THINK1	Hmmm…		
GAMEPLAY_EMOTE_HERO_05A_THINK2	Wen soll mein Pfeil treffen?		
GAMEPLAY_EMOTE_HERO_05A_THINK3	Was soll ich tun?		
GAMEPLAY_EMOTE_HERO_05A_THREATEN	Meine Rache folgt auf dem Fuße.		
GAMEPLAY_EMOTE_HERO_05A_TIMER	Handeln wir! Jetzt!		
GAMEPLAY_EMOTE_HERO_05A_WELL_PLAYED	Gut gespielt.		
GAMEPLAY_EMOTE_HERO_05A_WINTERVEIL_GREETING	Fröhliches Winterhauchfest!		
GAMEPLAY_EMOTE_HERO_05A_WOW	Unglaublich!		
GAMEPLAY_EMOTE_HERO_06_CONCEDE	Ich gebe mich geschlagen.		
GAMEPLAY_EMOTE_HERO_06_ERROR_FULL_MINIONS	Ich habe zu viele Diener.		
GAMEPLAY_EMOTE_HERO_06_ERROR_GENERIC	Das kann ich nicht tun.		
GAMEPLAY_EMOTE_HERO_06_ERROR_HAND_FULL	Meine Hand ist zu voll.		
GAMEPLAY_EMOTE_HERO_06_ERROR_I_ATTACKED	Ich habe bereits angegriffen.		
GAMEPLAY_EMOTE_HERO_06_ERROR_JUST_PLAYED	Dieser Diener wird in der nächsten Runde bereit sein.		
GAMEPLAY_EMOTE_HERO_06_ERROR_MINION_ATTACKED	Dieser Diener hat bereits angegriffen.		
GAMEPLAY_EMOTE_HERO_06_ERROR_NEED_MANA	Ich habe nicht genug Mana.		
GAMEPLAY_EMOTE_HERO_06_ERROR_NEED_WEAPON	Ich brauche eine Waffe.		
GAMEPLAY_EMOTE_HERO_06_ERROR_PLAY	Diese Aktion kann ich nicht ausführen.		
GAMEPLAY_EMOTE_HERO_06_ERROR_STEALTH	Ich kann verstohlene Diener nicht als Ziel wählen.		
GAMEPLAY_EMOTE_HERO_06_ERROR_TARGET	Das ist kein gültiges Ziel.		
GAMEPLAY_EMOTE_HERO_06_ERROR_TAUNT	Ein Diener mit Spott ist im Weg.		
GAMEPLAY_EMOTE_HERO_06_EVENT_LUNAR_NEW_YEAR	Grüße.		
GAMEPLAY_EMOTE_HERO_06_GOOD_GAME	Gutes Spiel!		
GAMEPLAY_EMOTE_HERO_06_GREETINGS	Grüße.		
GAMEPLAY_EMOTE_HERO_06_LOW_CARDS	Ich habe fast keine Karten mehr.		
GAMEPLAY_EMOTE_HERO_06_MIRROR_START	Die Natur muss bewahrt werden!		
GAMEPLAY_EMOTE_HERO_06_NO_CARDS	Ich habe keine Karten mehr!		
GAMEPLAY_EMOTE_HERO_06_OOPS	Fehler geschehen. Selbst in der Natur.		
GAMEPLAY_EMOTE_HERO_06_SORRY	Das tut mir leid.		
GAMEPLAY_EMOTE_HERO_06_START	Ich muss die Wildnis schützen!		
GAMEPLAY_EMOTE_HERO_06_START_TYRANDE	Meine geliebte Tyrande.		
GAMEPLAY_EMOTE_HERO_06_THANKS	Ich danke Euch.		
GAMEPLAY_EMOTE_HERO_06_THINK1	Hmm ...		
GAMEPLAY_EMOTE_HERO_06_THINK2	Hmm ... Ich frage mich, ob ...		
GAMEPLAY_EMOTE_HERO_06_THINK3	Was tun ...		
GAMEPLAY_EMOTE_HERO_06_THREATEN	Die Natur wird sich gegen Euch erheben!		
GAMEPLAY_EMOTE_HERO_06_TIMER	Die Zeit wartet auf niemanden_...		
GAMEPLAY_EMOTE_HERO_06_WELL_PLAYED	Hmm, gut gespielt.		
GAMEPLAY_EMOTE_HERO_06_WINTERVEIL_GREETINGS	Frohes Winterhauchfest!		
GAMEPLAY_EMOTE_HERO_06_WOW	Spektakulär!		
GAMEPLAY_EMOTE_HERO_07_CONCEDE	Dieses Mal gewinnt Ihr ...		
GAMEPLAY_EMOTE_HERO_07_ERROR_FULL_MINIONS	Ich habe zu viele Diener.		
GAMEPLAY_EMOTE_HERO_07_ERROR_GENERIC	Das kann ich nicht tun.		
GAMEPLAY_EMOTE_HERO_07_ERROR_HAND_FULL	Meine Hand ist zu voll.		
GAMEPLAY_EMOTE_HERO_07_ERROR_I_ATTACKED	Ich habe bereits angegriffen.		
GAMEPLAY_EMOTE_HERO_07_ERROR_JUST_PLAYED	Dieser Diener wird in der nächsten Runde bereit sein.		
GAMEPLAY_EMOTE_HERO_07_ERROR_MINION_ATTACKED	Dieser Diener hat bereits angegriffen.		
GAMEPLAY_EMOTE_HERO_07_ERROR_NEED_MANA	Ich habe nicht genug Mana.		
GAMEPLAY_EMOTE_HERO_07_ERROR_NEED_WEAPON	Ich brauche eine Waffe.		
GAMEPLAY_EMOTE_HERO_07_ERROR_PLAY	Diese Aktion kann ich nicht ausführen.		
GAMEPLAY_EMOTE_HERO_07_ERROR_STEALTH	Ich kann verstohlene Diener nicht als Ziel wählen.		
GAMEPLAY_EMOTE_HERO_07_ERROR_TARGET	Das ist kein gültiges Ziel.		
GAMEPLAY_EMOTE_HERO_07_ERROR_TAUNT	Ein Diener mit Spott ist im Weg.		
GAMEPLAY_EMOTE_HERO_07_EVENT_LUNAR_NEW_YEAR	Ich grüße Euch.		
GAMEPLAY_EMOTE_HERO_07_GOOD_GAME	Gutes Spiel!		
GAMEPLAY_EMOTE_HERO_07_GREETINGS	Ich grüße Euch.		
GAMEPLAY_EMOTE_HERO_07_LOW_CARDS	Ich habe fast keine Karten mehr.		
GAMEPLAY_EMOTE_HERO_07_MIRROR_START	Ich bin Euer schlimmster Alptraum!		
GAMEPLAY_EMOTE_HERO_07_NO_CARDS	Ich habe keine Karten mehr!		
GAMEPLAY_EMOTE_HERO_07_OOPS	Das war ein Fehler.		
GAMEPLAY_EMOTE_HERO_07_SORRY	Entschuldigung.		
GAMEPLAY_EMOTE_HERO_07_START	Eure Seele wird mir gehören!		
GAMEPLAY_EMOTE_HERO_07_THANKS	Vielen Dank.		
GAMEPLAY_EMOTE_HERO_07_THINK1	Hmm ...		
GAMEPLAY_EMOTE_HERO_07_THINK2	Ich frage mich, ob ...		
GAMEPLAY_EMOTE_HERO_07_THINK3	So viele Möglichkeiten_...		
GAMEPLAY_EMOTE_HERO_07_THREATEN	Dafür werdet Ihr büßen!		
GAMEPLAY_EMOTE_HERO_07_TIMER	Die Zeit ist fast um!		
GAMEPLAY_EMOTE_HERO_07_WELL_PLAYED	Gut gespielt.		
GAMEPLAY_EMOTE_HERO_07_WINTERVEIL_GREETINGS	Angenehmes Winterhauchfest!		
GAMEPLAY_EMOTE_HERO_07_WOW	Außerordentlich!		
GAMEPLAY_EMOTE_HERO_08_CONCEDE	Diese Runde geht an Euch ...		
GAMEPLAY_EMOTE_HERO_08_ERROR_FULL_MINIONS	Ich habe zu viele Diener.		
GAMEPLAY_EMOTE_HERO_08_ERROR_GENERIC	Das kann ich nicht tun.		
GAMEPLAY_EMOTE_HERO_08_ERROR_HAND_FULL	Meine Hand ist zu voll.		
GAMEPLAY_EMOTE_HERO_08_ERROR_I_ATTACKED	Ich habe bereits angegriffen.		
GAMEPLAY_EMOTE_HERO_08_ERROR_JUST_PLAYED	Dieser Diener wird in der nächsten Runde bereit sein.		
GAMEPLAY_EMOTE_HERO_08_ERROR_MINION_ATTACKED	Dieser Diener hat bereits angegriffen.		
GAMEPLAY_EMOTE_HERO_08_ERROR_NEED_MANA	Ich habe nicht genug Mana.		
GAMEPLAY_EMOTE_HERO_08_ERROR_NEED_WEAPON	Ich brauche eine Waffe.		
GAMEPLAY_EMOTE_HERO_08_ERROR_PLAY	Diese Aktion kann ich nicht ausführen.		
GAMEPLAY_EMOTE_HERO_08_ERROR_STEALTH	Ich kann verstohlene Diener nicht als Ziel wählen.		
GAMEPLAY_EMOTE_HERO_08_ERROR_TARGET	Das ist kein gültiges Ziel.		
GAMEPLAY_EMOTE_HERO_08_ERROR_TAUNT	Ein Diener mit Spott ist im Weg.		
GAMEPLAY_EMOTE_HERO_08_EVENT_LUNAR_NEW_YEAR	Hallo!		
GAMEPLAY_EMOTE_HERO_08_GOOD_GAME	Gutes Spiel!		
GAMEPLAY_EMOTE_HERO_08_GREETINGS	Hallo!		
GAMEPLAY_EMOTE_HERO_08_LOW_CARDS	Ich habe fast keine Karten mehr.		
GAMEPLAY_EMOTE_HERO_08_MIRROR_START	Darauf könnt Ihr Gift nehmen.		
GAMEPLAY_EMOTE_HERO_08_NO_CARDS	Ich habe keine Karten mehr!		
GAMEPLAY_EMOTE_HERO_08_OOPS	Ups!		
GAMEPLAY_EMOTE_HERO_08_SORRY	Es tut mir leid.		
GAMEPLAY_EMOTE_HERO_08_START	Ihr habt es so gewollt.		
GAMEPLAY_EMOTE_HERO_08_THANKS	Danke.		
GAMEPLAY_EMOTE_HERO_08_THINK1	Hmm ...		
GAMEPLAY_EMOTE_HERO_08_THINK2	Ich frage mich, ob ...		
GAMEPLAY_EMOTE_HERO_08_THINK3	Was soll ich nur tun ...		
GAMEPLAY_EMOTE_HERO_08_THREATEN	Meine Magie wird Euch in Stücke reißen!		
GAMEPLAY_EMOTE_HERO_08_TIMER	Mir läuft die Zeit davon ...		
GAMEPLAY_EMOTE_HERO_08_WELL_PLAYED	Gut gespielt.		
GAMEPLAY_EMOTE_HERO_08_WINTERVEIL_GREETINGS	Ein frohes Winterhauchfest wünsche ich Euch!		
GAMEPLAY_EMOTE_HERO_08_WOW	Fantastisch!		
GAMEPLAY_EMOTE_HERO_08A_CONCEDE	Schachmatt! Gute Leistung.		
GAMEPLAY_EMOTE_HERO_08A_ERROR_FULL_MINIONS	Ich habe zu viele Diener.		
GAMEPLAY_EMOTE_HERO_08A_ERROR_GENERIC	Das kann ich nicht tun.		
GAMEPLAY_EMOTE_HERO_08A_ERROR_HAND_FULL	Meine Hand ist zu voll.		
GAMEPLAY_EMOTE_HERO_08A_ERROR_I_ATTACKED	Ich habe bereits angegriffen.		
GAMEPLAY_EMOTE_HERO_08A_ERROR_JUST_PLAYED	Dieser Diener wird in der nächsten Runde bereit sein.		
GAMEPLAY_EMOTE_HERO_08A_ERROR_MINION_ATTACKED	Dieser Diener hat bereits angegriffen.		
GAMEPLAY_EMOTE_HERO_08A_ERROR_NEED_MANA	Ich habe nicht genug Mana.		
GAMEPLAY_EMOTE_HERO_08A_ERROR_NEED_WEAPON	Ich brauche eine Waffe.		
GAMEPLAY_EMOTE_HERO_08A_ERROR_PLAY	Diese Aktion kann ich nicht ausführen.		
GAMEPLAY_EMOTE_HERO_08A_ERROR_STEALTH	Ich kann verstohlene Diener nicht als Ziel wählen.		
GAMEPLAY_EMOTE_HERO_08A_ERROR_TARGET	Das ist kein gültiges Ziel.		
GAMEPLAY_EMOTE_HERO_08A_ERROR_TAUNT	Ich muss den Diener mit Spott angreifen.		
GAMEPLAY_EMOTE_HERO_08A_GOOD_GAME	Gutes Spiel!		
GAMEPLAY_EMOTE_HERO_08A_GREETINGS	Ich grüße Euch.		
GAMEPLAY_EMOTE_HERO_08A_LOW_CARDS	Ich habe fast keine Karten mehr.		
GAMEPLAY_EMOTE_HERO_08A_LUNAR_NEW_YEAR	Ich grüße Euch.		
GAMEPLAY_EMOTE_HERO_08A_MIRROR_START	Oh, das haben sie längst.		
GAMEPLAY_EMOTE_HERO_08A_NO_CARDS	Ich habe keine Karten mehr!		
GAMEPLAY_EMOTE_HERO_08A_OOPS	Das war töricht.		
GAMEPLAY_EMOTE_HERO_08A_SORRY	Das tut mir aufrichtig leid.		
GAMEPLAY_EMOTE_HERO_08A_START	Mögen die Spiele beginnen!		
GAMEPLAY_EMOTE_HERO_08A_THANKS	Besten Dank.		
GAMEPLAY_EMOTE_HERO_08A_THINK1	Hmmm…		
GAMEPLAY_EMOTE_HERO_08A_THINK2	Interessant ...		
GAMEPLAY_EMOTE_HERO_08A_THINK3	Vielleicht ...		
GAMEPLAY_EMOTE_HERO_08A_THREATEN	Nichts kann mich aufhalten! Nichts.		
GAMEPLAY_EMOTE_HERO_08A_TIMER	Die Zeit wartet auf niemanden.		
GAMEPLAY_EMOTE_HERO_08A_WELL_PLAYED	Gut gespielt.		
GAMEPLAY_EMOTE_HERO_08A_WINTERVEIL_GREETINGS	Frohes Feiern.		
GAMEPLAY_EMOTE_HERO_08A_WOW	Unglaublich.		
GAMEPLAY_EMOTE_HERO_08B_CONCEDE	Sehr gut. Ihr habt gewonnen.		
GAMEPLAY_EMOTE_HERO_08B_ERROR_FULL_MINIONS	Ich habe zu viele Diener.		
GAMEPLAY_EMOTE_HERO_08B_ERROR_GENERIC	Das kann ich nicht tun.		
GAMEPLAY_EMOTE_HERO_08B_ERROR_HAND_FULL	Meine Hand ist zu voll.		
GAMEPLAY_EMOTE_HERO_08B_ERROR_I_ATTACKED	Ich habe bereits angegriffen.		
GAMEPLAY_EMOTE_HERO_08B_ERROR_JUST_PLAYED	Dieser Diener wird in der nächsten Runde bereit sein.		
GAMEPLAY_EMOTE_HERO_08B_ERROR_MINION_ATTACKED	Dieser Diener hat bereits angegriffen.		
GAMEPLAY_EMOTE_HERO_08B_ERROR_NEED_MANA	Ich habe nicht genug Mana.		
GAMEPLAY_EMOTE_HERO_08B_ERROR_NEED_WEAPON	Ich brauche eine Waffe.		
GAMEPLAY_EMOTE_HERO_08B_ERROR_PLAY	Diese Aktion kann ich nicht ausführen.		
GAMEPLAY_EMOTE_HERO_08B_ERROR_STEALTH	Ich kann verstohlene Diener nicht als Ziel wählen.		
GAMEPLAY_EMOTE_HERO_08B_ERROR_TARGET	Das ist kein gültiges Ziel.		
GAMEPLAY_EMOTE_HERO_08B_ERROR_TAUNT	Ein Diener mit Spott ist im Weg.		
GAMEPLAY_EMOTE_HERO_08B_GOOD_GAME	Nun ... das war ein gutes Spiel!		
GAMEPLAY_EMOTE_HERO_08B_GREETINGS	Grüße, Sucher der Wahrheit.		
GAMEPLAY_EMOTE_HERO_08B_LOW_CARDS	Ich habe fast keine Karten mehr.		
GAMEPLAY_EMOTE_HERO_08B_LUNAR_NEW_YEAR	Grüße, Sucher der Wahrheit.		
GAMEPLAY_EMOTE_HERO_08B_MIRROR_START	Auf dass wir gemeinsam unser Wissen mehren.		
GAMEPLAY_EMOTE_HERO_08B_NO_CARDS	Ich habe keine Karten mehr!		
GAMEPLAY_EMOTE_HERO_08B_OOPS	Oh. Ups.		
GAMEPLAY_EMOTE_HERO_08B_SORRY	Oh, das tut mir leid.		
GAMEPLAY_EMOTE_HERO_08B_START	Wissen ist Macht.		
GAMEPLAY_EMOTE_HERO_08B_THANKS	Ich danke Euch.		
GAMEPLAY_EMOTE_HERO_08B_THINK1	Hmm...		
GAMEPLAY_EMOTE_HERO_08B_THINK2	Observieren und reflektieren ...		
GAMEPLAY_EMOTE_HERO_08B_THINK3	Es muss doch einen Weg geben ...		
GAMEPLAY_EMOTE_HERO_08B_THREATEN	Zeit für eine Lektion, unverschämter Emporkömmling!		
GAMEPLAY_EMOTE_HERO_08B_TIMER	Oh, die Zeit verfliegt!		
GAMEPLAY_EMOTE_HERO_08B_WELL_PLAYED	Gut gespielt.		
GAMEPLAY_EMOTE_HERO_08B_WINTERVEIL_GREETINGS	Ein frohes Winterhauchfest wünsche ich Euch!		
GAMEPLAY_EMOTE_HERO_08B_WOW	Vortrefflich!		
GAMEPLAY_EMOTE_HERO_09_CONCEDE	Ihr habt mich besiegt.		
GAMEPLAY_EMOTE_HERO_09_ERROR_FULL_MINIONS	Ich habe zu viele Diener.		
GAMEPLAY_EMOTE_HERO_09_ERROR_GENERIC	Das kann ich nicht tun.		
GAMEPLAY_EMOTE_HERO_09_ERROR_HAND_FULL	Meine Hand ist zu voll.		
GAMEPLAY_EMOTE_HERO_09_ERROR_I_ATTACKED	Ich habe bereits angegriffen.		
GAMEPLAY_EMOTE_HERO_09_ERROR_JUST_PLAYED	Dieser Diener wird in der nächsten Runde bereit sein.		
GAMEPLAY_EMOTE_HERO_09_ERROR_MINION_ATTACKED	Dieser Diener hat bereits angegriffen.		
GAMEPLAY_EMOTE_HERO_09_ERROR_NEED_MANA	Ich habe nicht genug Mana.		
GAMEPLAY_EMOTE_HERO_09_ERROR_NEED_WEAPON	Ich brauche eine Waffe.		
GAMEPLAY_EMOTE_HERO_09_ERROR_PLAY	Diese Aktion kann ich nicht ausführen.		
GAMEPLAY_EMOTE_HERO_09_ERROR_STEALTH	Ich kann verstohlene Diener nicht als Ziel wählen.		
GAMEPLAY_EMOTE_HERO_09_ERROR_TARGET	Das ist kein gültiges Ziel.		
GAMEPLAY_EMOTE_HERO_09_ERROR_TAUNT	Ein Diener mit Spott ist im Weg.		
GAMEPLAY_EMOTE_HERO_09_EVENT_LUNAR_NEW_YEAR	Grüße!		
GAMEPLAY_EMOTE_HERO_09_GOOD_GAME	Gutes Spiel!		
GAMEPLAY_EMOTE_HERO_09_GREETINGS	Grüße!		
GAMEPLAY_EMOTE_HERO_09_LOW_CARDS	Ich habe fast keine Karten mehr.		
GAMEPLAY_EMOTE_HERO_09_MIRROR_START	Das Licht ist mit den Gerechten!		
GAMEPLAY_EMOTE_HERO_09_NO_CARDS	Ich habe keine Karten mehr!		
GAMEPLAY_EMOTE_HERO_09_OOPS	Nicht ganz wie geplant ...		
GAMEPLAY_EMOTE_HERO_09_SORRY	Entschuldigt bitte.		
GAMEPLAY_EMOTE_HERO_09_START	Das Licht wird den Sieg bringen!		
GAMEPLAY_EMOTE_HERO_09_THANKS	Danke!		
GAMEPLAY_EMOTE_HERO_09_THINK1	Hmm ...		
GAMEPLAY_EMOTE_HERO_09_THINK2	Ich frage mich, ob ...		
GAMEPLAY_EMOTE_HERO_09_THINK3	Das sollte ich mir gründlich überlegen_…		
GAMEPLAY_EMOTE_HERO_09_THREATEN	Möge das Licht Euch verbrennen!		
GAMEPLAY_EMOTE_HERO_09_TIMER	Ich muss mich schnell entscheiden ...		
GAMEPLAY_EMOTE_HERO_09_WELL_PLAYED	Gut gespielt.		
GAMEPLAY_EMOTE_HERO_09_WINTERVEIL_GREETINGS	Frohes Winterhauchfest!		
GAMEPLAY_EMOTE_HERO_09_WOW	Wow!		
GAMEPLAY_EMOTE_HERO_TBKTRAF_KT_CONCEDE	Ich ... werde ... zurückkehren ...		
GAMEPLAY_EMOTE_HERO_TBKTRAF_KT_GREETINGS	Endlich lernen wir uns kennen.		
GAMEPLAY_EMOTE_HERO_TBKTRAF_KT_LOW_CARDS	Ich habe fast keine Karten mehr!		
GAMEPLAY_EMOTE_HERO_TBKTRAF_KT_NO_CARDS	Nein! Ich verfluche Euch, Eindringling!		
GAMEPLAY_EMOTE_HERO_TBKTRAF_KT_OOPS	*Seufzt* Und noch mal von vorne ...		
GAMEPLAY_EMOTE_HERO_TBKTRAF_KT_SORRY	Nein! Ich verfluche Euch, Eindringling!		
GAMEPLAY_EMOTE_HERO_TBKTRAF_KT_START	Stellt Euch mir, Eindringling!		
GAMEPLAY_EMOTE_HERO_TBKTRAF_KT_THANKS	Keine ... Ursache?		
GAMEPLAY_EMOTE_HERO_TBKTRAF_KT_THINK1	Vielleicht?		
GAMEPLAY_EMOTE_HERO_TBKTRAF_KT_THINK2	Ja ... ja!		
GAMEPLAY_EMOTE_HERO_TBKTRAF_KT_THINK3	Was denkst du, Mr. Bigglesworth?		
GAMEPLAY_EMOTE_HERO_TBKTRAF_KT_THREATEN	Ich werde das Blut in Euren Adern gefrieren lassen!		
GAMEPLAY_EMOTE_HERO_TBKTRAF_KT_WELL_PLAYED	Ha, selbstverständlich habe ich gut gespielt. Ich bin schließlich Kel'Thuzad.		
GAMEPLAY_EMOTE_HERO_TBKTRAF_RAF_CONCEDE	NEIN! ICH BIN DOCH UNBESIEGBAR ...		
GAMEPLAY_EMOTE_HERO_TBKTRAF_RAF_GREETINGS	Hallo, Forscher.		
GAMEPLAY_EMOTE_HERO_TBKTRAF_RAF_LOW_CARDS	Ich habe fast keine Karten mehr!		
GAMEPLAY_EMOTE_HERO_TBKTRAF_RAF_NO_CARDS	Meine wunderschönen Schätze!		
GAMEPLAY_EMOTE_HERO_TBKTRAF_RAF_OOPS	Versagen!		
GAMEPLAY_EMOTE_HERO_TBKTRAF_RAF_SORRY	Ich bemitleide Euch.		
GAMEPLAY_EMOTE_HERO_TBKTRAF_RAF_START	RAFAAM, DER GRÖSSTE ALLER ARCHÄOLOGEN!		
GAMEPLAY_EMOTE_HERO_TBKTRAF_RAF_THANKS	Oh, danke.		
GAMEPLAY_EMOTE_HERO_TBKTRAF_RAF_THINK1	Hmm ...		
GAMEPLAY_EMOTE_HERO_TBKTRAF_RAF_THINK2	Was soll ich mir nur nehmen ...		
GAMEPLAY_EMOTE_HERO_TBKTRAF_RAF_THINK3	Wie verlockend ...		
GAMEPLAY_EMOTE_HERO_TBKTRAF_RAF_THREATEN	ÜBERWÄLTIGENDE MACHT!		
GAMEPLAY_EMOTE_HERO_TBKTRAF_RAF_WELL_PLAYED	Gut gespielt.		
GAMEPLAY_EMOTE_HERO_TBMECHWAR01_CONCEDE	<Kapitulation!>	The text is in brackets because the VO files is just Annoy-o-Tron's greeting	
GAMEPLAY_EMOTE_HERO_TBMECHWAR01_ERROR_FULL_MINIONS	<Fehler!>	The text is in brackets because the VO files is just Annoy-o-Tron's greeting	
GAMEPLAY_EMOTE_HERO_TBMECHWAR01_ERROR_HAND_FULL	<Fehler!>	The text is in brackets because the VO files is just Annoy-o-Tron's greeting	
GAMEPLAY_EMOTE_HERO_TBMECHWAR01_ERROR_I_ATTACKED	<Fehler!>	The text is in brackets because the VO files is just Annoy-o-Tron's greeting	
GAMEPLAY_EMOTE_HERO_TBMECHWAR01_ERROR_JUST_PLAYED	<Fehler!>	The text is in brackets because the VO files is just Annoy-o-Tron's greeting	
GAMEPLAY_EMOTE_HERO_TBMECHWAR01_ERROR_MINION_ATTACKED	<Fehler!>	The text is in brackets because the VO files is just Annoy-o-Tron's greeting	
GAMEPLAY_EMOTE_HERO_TBMECHWAR01_ERROR_NEED_MANA	<Fehler!>	The text is in brackets because the VO files is just Annoy-o-Tron's greeting	
GAMEPLAY_EMOTE_HERO_TBMECHWAR01_ERROR_NEED_WEAPON	<Fehler!>	The text is in brackets because the VO files is just Annoy-o-Tron's greeting	
GAMEPLAY_EMOTE_HERO_TBMECHWAR01_ERROR_PLAY	<Fehler!>	The text is in brackets because the VO files is just Annoy-o-Tron's greeting	
GAMEPLAY_EMOTE_HERO_TBMECHWAR01_ERROR_STEALTH	<Fehler!>	The text is in brackets because the VO files is just Annoy-o-Tron's greeting	
GAMEPLAY_EMOTE_HERO_TBMECHWAR01_ERROR_TARGET	<Fehler!>	The text is in brackets because the VO files is just Annoy-o-Tron's greeting	
GAMEPLAY_EMOTE_HERO_TBMECHWAR01_ERROR_TAUNT	<Fehler!>	The text is in brackets because the VO files is just Annoy-o-Tron's greeting	
GAMEPLAY_EMOTE_HERO_TBMECHWAR01_GREETINGS	<Grüße!>	The text is in brackets because the VO files is just Annoy-o-Tron's greeting	
GAMEPLAY_EMOTE_HERO_TBMECHWAR01_LOW_CARDS	<Wenig Karten!>	The text is in brackets because the VO files is just Annoy-o-Tron's greeting	
GAMEPLAY_EMOTE_HERO_TBMECHWAR01_NO_CARDS	<Keine Karten!>	The text is in brackets because the VO files is just Annoy-o-Tron's greeting	
GAMEPLAY_EMOTE_HERO_TBMECHWAR01_OOPS	<Fehler!>	The text is in brackets because the VO files is just Annoy-o-Tron's greeting	
GAMEPLAY_EMOTE_HERO_TBMECHWAR01_SORRY	<Entschuldigung!>	The text is in brackets because the VO files is just Annoy-o-Tron's greeting	
GAMEPLAY_EMOTE_HERO_TBMECHWAR01_START	<Start!>	The text is in brackets because the VO files is just Annoy-o-Tron's greeting	
GAMEPLAY_EMOTE_HERO_TBMECHWAR01_THANKS	<Danke!>	The text is in brackets because the VO files is just Annoy-o-Tron's greeting	
GAMEPLAY_EMOTE_HERO_TBMECHWAR01_THINK1	<Verarbeite Daten ...>	The text is in brackets because the VO files is just Annoy-o-Tron's greeting	
GAMEPLAY_EMOTE_HERO_TBMECHWAR01_THINK2	<Erfasse Ziel ...>	The text is in brackets because the VO files is just Annoy-o-Tron's greeting	
GAMEPLAY_EMOTE_HERO_TBMECHWAR01_THINK3	<Verschwende Taktzyklen ...>	The text is in brackets because the VO files is just Annoy-o-Tron's greeting	
GAMEPLAY_EMOTE_HERO_TBMECHWAR01_THREATEN	<Drohung!>	The text is in brackets because the VO files is just Annoy-o-Tron's attack	
GAMEPLAY_EMOTE_HERO_TBMECHWAR01_TIMER	<Wenig Zeit!>	The text is in brackets because the VO files is just Annoy-o-Tron's greeting	
GAMEPLAY_EMOTE_HERO_TBMECHWAR01_WELL_PLAYED	<Gut gespielt!>	The text is in brackets because the VO files is just Annoy-o-Tron's greeting	
GAMEPLAY_EMOTE_HERO_TBMECHWAR01_WOW	<Unglaublich!>	The text is in brackets because the VO files is just Annoy-o-Tron's greeting	
GAMEPLAY_EMOTE_HERO_TBMECHWAR02_CONCEDE	<Zeilenende erreicht>	The text is in brackets because the VO files is just Boom Bot's greeting	
GAMEPLAY_EMOTE_HERO_TBMECHWAR02_ERROR_FULL_MINIONS	<Fehler!>	The text is in brackets because the VO files is just Boom Bot's greeting	
GAMEPLAY_EMOTE_HERO_TBMECHWAR02_ERROR_HAND_FULL	<Fehler!>	The text is in brackets because the VO files is just Boom Bot's greeting	
GAMEPLAY_EMOTE_HERO_TBMECHWAR02_ERROR_I_ATTACKED	<Fehler!>	The text is in brackets because the VO files is just Boom Bot's greeting	
GAMEPLAY_EMOTE_HERO_TBMECHWAR02_ERROR_JUST_PLAYED	<Fehler!>	The text is in brackets because the VO files is just Boom Bot's greeting	
GAMEPLAY_EMOTE_HERO_TBMECHWAR02_ERROR_MINION_ATTACKED	<Fehler!>	The text is in brackets because the VO files is just Boom Bot's greeting	
GAMEPLAY_EMOTE_HERO_TBMECHWAR02_ERROR_NEED_MANA	<Fehler!>	The text is in brackets because the VO files is just Boom Bot's greeting	
GAMEPLAY_EMOTE_HERO_TBMECHWAR02_ERROR_NEED_WEAPON	<Fehler!>	The text is in brackets because the VO files is just Boom Bot's greeting	
GAMEPLAY_EMOTE_HERO_TBMECHWAR02_ERROR_PLAY	<Fehler!>	The text is in brackets because the VO files is just Boom Bot's greeting	
GAMEPLAY_EMOTE_HERO_TBMECHWAR02_ERROR_STEALTH	<Fehler!>	The text is in brackets because the VO files is just Boom Bot's greeting	
GAMEPLAY_EMOTE_HERO_TBMECHWAR02_ERROR_TARGET	<Fehler!>	The text is in brackets because the VO files is just Boom Bot's greeting	
GAMEPLAY_EMOTE_HERO_TBMECHWAR02_ERROR_TAUNT	<Fehler!>	The text is in brackets because the VO files is just Boom Bot's greeting	
GAMEPLAY_EMOTE_HERO_TBMECHWAR02_GREETINGS	<Grüße>	The text is in brackets because the VO files is just Annoy-o-Tron's greeting	
GAMEPLAY_EMOTE_HERO_TBMECHWAR02_LOW_CARDS	<Wenig Karten>	The text is in brackets because the VO files is just Boom Bot's greeting	
GAMEPLAY_EMOTE_HERO_TBMECHWAR02_NO_CARDS	<Keine Karten>	The text is in brackets because the VO files is just Boom Bot's greeting	
GAMEPLAY_EMOTE_HERO_TBMECHWAR02_OOPS	<Fehler>	The text is in brackets because the VO files is just Boom Bot's greeting	
GAMEPLAY_EMOTE_HERO_TBMECHWAR02_SORRY	<Entschuldigung>	The text is in brackets because the VO files is just Boom Bot's greeting	
GAMEPLAY_EMOTE_HERO_TBMECHWAR02_START	<Beginn>	The text is in brackets because the VO files is just Boom Bot's greeting	
GAMEPLAY_EMOTE_HERO_TBMECHWAR02_THANKS	<Danke>	The text is in brackets because the VO files is just Boom Bot's greeting	
GAMEPLAY_EMOTE_HERO_TBMECHWAR02_THINK1	<Verarbeite Daten ...>	The text is in brackets because the VO files is just Boom Bot's greeting	
GAMEPLAY_EMOTE_HERO_TBMECHWAR02_THINK2	<Erfasse Ziel ...>	The text is in brackets because the VO files is just Boom Bot's greeting	
GAMEPLAY_EMOTE_HERO_TBMECHWAR02_THINK3	<Verschwende Taktzyklen ...>	The text is in brackets because the VO files is just Boom Bot's greeting	
GAMEPLAY_EMOTE_HERO_TBMECHWAR02_THREATEN	<Drohung>	The text is in brackets because the VO files is just Boom Bot's Attack sound	
GAMEPLAY_EMOTE_HERO_TBMECHWAR02_TIMER	<Wenig Zeit>	The text is in brackets because the VO files is just Boom Bot's greeting	
GAMEPLAY_EMOTE_HERO_TBMECHWAR02_WELL_PLAYED	<Gut gespielt>	The text is in brackets because the VO files is just Boom Bot's greeting	
GAMEPLAY_EMOTE_HERO_TBMECHWAR02_WOW	<Erstaunlich!>	The text is in brackets because the VO files is just Annoy-o-Tron's greeting	
VO_BRM_027h__LUNAR_NEW_YEAR	DAS FEUER WIRD EUCH LÄUTERN!		
VO_BRM_027h_Attack_15	SPÜRT DIE FLAMMEN VON SULFURON!		
VO_BRM_027h_Concede_11	IHR GEWINNT! GUTES SPIEL!		
VO_BRM_027h_Emote_Start	ICH WERDE MICH RÄCHEN, DRACHE!		
VO_BRM_027h_ERROR01_51	ICH BRAUCHE EINE WAFFE!		
VO_BRM_027h_ERROR02_52	NICHT GENUG MANA!		
VO_BRM_027h_ERROR03_53	DIESER DIENER HAT BEREITS ANGEGRIFFEN.		
VO_BRM_027h_ERROR04_54	ICH HABE BEREITS ANGEGRIFFEN.		
VO_BRM_027h_ERROR05_55	STERBLICHE BRAUCHEN EINEN ZUG, UM SICH VORZUBEREITEN.		
VO_BRM_027h_ERROR06_56	ZU VIELE KARTEN!		
VO_BRM_027h_ERROR07_57	ZU VIELE DIENER!		
VO_BRM_027h_ERROR08_58	DIESER DIENER IST VERSTOHLEN.		
VO_BRM_027h_ERROR09_59	KANN ICH NICHT SPIELEN.		
VO_BRM_027h_ERROR10_60	DAS GEHT NICHT.		
VO_BRM_027h_ERROR11_61	DIESER DIENER MIT SPOTT IST MIR IM WEG!		
VO_BRM_027h_ERROR12_62	DAS KANN ICH NICHT TUN.		
VO_BRM_027h_GG_16	GUTES SPIEL!		
VO_BRM_027h_Greetings_04	DAS FEUER WIRD EUCH LÄUTERN!		
VO_BRM_027h_HAPPY_NEW_YEAR_38	ICH WERDE DAS NEUE JAHR MIT EINEM FEUERWERK BEGRÜSSEN!		
VO_BRM_027h_LowCards_49	ICH HABE FAST ALLE MEINE KARTEN VERBRANNT!		
VO_BRM_027h_NoCards_50	ICH HABE ALLE MEINE KARTEN VERBRANNT!		
VO_BRM_027h_Oops_07	GAH! EIN FEHLER!		
VO_BRM_027h_Sorry_10	ENTSCHULDIGUNG!		
VO_BRM_027h_Thanks_09	HEISSEN DANK.		
VO_BRM_027h_Thinking1_12	HMMM ...		
VO_BRM_027h_Thinking2_13	WAS TUN ...		
VO_BRM_027h_Thinking3_14	WAS BRENNT DENN AM BESTEN ...		
VO_BRM_027h_Threaten_08	IHR WERDET IN DEN LODERNDEN FLAMMEN VERGEHEN!		
VO_BRM_027h_Time_48	ICH HABE FEUER UNTERM HINTERN!		
VO_BRM_027h_Well_Played_06	GUT GESPIELT!		
VO_BRM_027h_Winterveil_Greetings	DER WINTER SOLLTE WÄRMER SEIN.		
VO_BRM_027h_WOW_20	DAS ERWÄRMT MIR DAS HERZ!		
VO_HERO_09a_Attack_15	Für Elune!		
VO_HERO_09a_BRB_32	Ich bin gleich wieder da.		
VO_HERO_09a_CELEBRATE_39	Freut Euch!		
VO_HERO_09a_CONCEDE_06	Es ist aus. Ihr gewinnt!		
VO_HERO_09a_CONGRATULATIONS_42	Meinen Glückwunsch.		
VO_HERO_09a_DAY_OF_THE_DEAD_61	Mondgöttin, segnet die Gefallenen.		
VO_HERO_09a_END_OF_SEASON_49	Die Saison neigt sich dem Ende zu.		
VO_HERO_09a_ERROR_FULL_MINIONS_25	Ich habe zu viele Diener.		
VO_HERO_09a_ERROR_GENERIC_30	Das kann ich nicht tun.		
VO_HERO_09a_ERROR_HAND_FULL_24	Meine Hand ist zu voll.		
VO_HERO_09a_ERROR_I_ATTACKED_22	Ich habe bereits angegriffen.		
VO_HERO_09a_ERROR_JUST_PLAYED_23	Dieser Diener wird in der nächsten Runde bereit sein.		
VO_HERO_09a_ERROR_MINION_ATTACKED_21	Dieser Diener hat bereits angegriffen.		
VO_HERO_09a_ERROR_NEED_MANA_20	Ich habe nicht genug Mana.		
VO_HERO_09a_ERROR_NEED_WEAPON_19	Ich brauche eine Waffe.		
VO_HERO_09a_ERROR_PLAY_27	Diese Aktion kann ich nicht ausführen.		
VO_HERO_09a_ERROR_STEALTH_26	Ich kann verstohlene Diener nicht als Ziel wählen.		
VO_HERO_09a_ERROR_TARGET_28	Das ist kein gültiges Ziel.		
VO_HERO_09a_ERROR_TAUNT_29	Ein Diener mit Spott ist im Weg.		
VO_HERO_09a_FACTION_CRY_44	Für die Allianz!		
VO_HERO_09a_FIDGET_38	Ich werde langsam ungeduldig_...		
VO_HERO_09a_FIRE_FESTIVAL_59	Ich wünsche Euch ein herrliches Sonnenwendfest!		
VO_HERO_09a_GOOD_GAME_31	Gut gespielt.		
VO_HERO_09a_GREETINGS_03	Gesegnet sollt Ihr sein.		
VO_HERO_09a_HAPPY_BIRTHDAY_50	Herzlichen Glückwunsch zum Geburtstag!		
VO_HERO_09a_HAPPY_BREWFEST_55	Fröhliches Braufest!		
VO_HERO_09a_HAPPY_EVENT_56	Was für ein schöner Tag!		
VO_HERO_09a_HAPPY_HALLOWEEN_51	Fröhliche Schlotternächte!		
VO_HERO_09a_HAPPY_HOLIDAYS_52	Frohes Winterhauchfest!		
VO_HERO_09a_HAPPY_NEW_YEAR_53	Frohes neues Jahr!		
VO_HERO_09a_HAPPY_NOBLEGARDEN_54	Fröhliches Nobelgartenfest.		
VO_HERO_09a_HUNGRY_46	Hmm_... frischgebackene Mondkuchen, das wär jetzt was.		
VO_HERO_09a_INDEED_34	In der Tat.		
VO_HERO_09a_KIDS_WEEK_58	Möge die Göttin die Kinder segnen.		
VO_HERO_09a_LOW_CARDS_17	Ich habe fast keine Karten mehr.		
VO_HERO_09a_MIRROR_GREETINGS_04	Ihr ebenfalls.		
VO_HERO_09a_MIRROR_START_02	Die Göttin ist mein Schild.		
VO_HERO_09a_NICE_CARD_BACK_33	Ein schöner Kartenrücken!		
VO_HERO_09a_NO_CARDS_18	Ich habe keine Karten mehr!		
VO_HERO_09a_OOPS_08	Das war ein Fehler.		
VO_HERO_09a_PARTY_37	Tanzt!		
VO_HERO_09a_PICKED_11	Die Göttin ruft!		
VO_HERO_09a_PIRATE_DAY_60	Machtwort: Ahoi!		
VO_HERO_09a_SALUTE_36	Ihr habt meinen Respekt.		
VO_HERO_09a_SORRY_10	Vergebt mir.		
VO_HERO_09a_START_01	Möge Elune mir Kraft geben!		
VO_HERO_09a_START_MALFURION	Malfurion_... Liebster!		
VO_HERO_09a_START_OF_SEASON_48	Eine neue Saison bricht an.		
VO_HERO_09a_THANKS_09	Danke.		
VO_HERO_09a_THANKSGIVING_62	Frohes Pilgerfreudenfest!		
VO_HERO_09a_THINK1_12	Hmm_…		
VO_HERO_09a_THINK2_13	Was tun_...		
VO_HERO_09a_THINK3_14	Was ist bloß Elunes Wille_...		
VO_HERO_09a_THREATEN_05	Das werdet Ihr bereuen!		
VO_HERO_09a_TIMER_16	Beeilt Euch!		
VO_HERO_09a_VALENTINES_57	Ich vermisse meinen liebsten Malfurion.		
VO_HERO_09a_WELCOME_45	Im Namen von Elune heiße ich Euch willkommen.		
VO_HERO_09a_WELL_PLAYED_07	Gut gespielt.		
VO_HERO_09a_WOW_35	Brillant!		
VO_TBA01_4__Concede	*Grrrr*		
VO_TBA01_4__Error_Full_Minions	*Grrrr*		
VO_TBA01_4__Error_Generic	*Grrrr*		
VO_TBA01_4__Error_Hand_Full	*Grrrr*		
VO_TBA01_4__Error_I_Attacked	*Grrrr*		
VO_TBA01_4__Error_Just_Played	*Grrrr*		
VO_TBA01_4__Error_Minion_Attacked	*Grrrr*		
VO_TBA01_4__Error_Need_Mana	*Grrrr*		
VO_TBA01_4__Error_Need_Weapon	*Grrrr*		
VO_TBA01_4__Error_Play	*Grrrr*		
VO_TBA01_4__Error_Stealth	*Grrrr*		
VO_TBA01_4__Good_Game	*Grrrr*		
VO_TBA01_4__Greetings	Lasst die Spiele beginnen!		
VO_TBA01_4__Low_Cards	*Grrrr*		
VO_TBA01_4__No_Cards	*Grrrr*		
VO_TBA01_4__Oops	GAH! EIN FEHLER!		
VO_TBA01_4__Sorry	ENTSCHULDIGUNG!		
VO_TBA01_4__Start	Ich bin hier der Meister!		
VO_TBA01_4__Thanks	HEISSEN DANK.		
VO_TBA01_4__Threaten	Seht! Die wahre Macht NEFARIANS!		
VO_TBA01_4__Timer	*Grrrr*		
VO_TBA01_4__Well_Played	GUT GESPIELT.		
