TAG	TEXT	COMMENT
LOEA16_2_STAFF_TEXT_CHARGE_0	<b>常動型ヒーローパワー</b>\n自分のヒーローは<b>無敵</b>。あと3ターン有効。	
LOEA16_2_STAFF_TEXT_CHARGE_1	<b>常動型ヒーローパワー</b>\n自分のヒーローは<b>無敵</b>。あと2ターン有効。	
LOEA16_2_STAFF_TEXT_CHARGE_2	<b>常動型ヒーローパワー</b>\n自分のヒーローは<b>無敵</b>。残り1ターン！	
LOEA16_2_STAFF_TEXT_CHARGE_EXPLODED	<b>常動型ヒーローパワー</b>\nボスを1体召喚した代わりに、<b>無敵</b>ではなくなった。	
MISSION_DEFAULTCOUNTERNAME	|4(ターン,ターン)で\n脱出	
MISSION_GLOWING_POOL	光る池	
MISSION_NEFARIAN_TITLE	マヌケで期待外れで役立たずなミニオン・スレイヤー	
MISSION_PIT_OF_SPIKES	串刺しの奈落	
MISSION_PRE_TUTORIAL_WANTED	WANTED	
MISSION_STATUES_EYE	彫像の眼	
MISSION_TAKE_THE_SHORTCUT	近道するかい？	
TB_100TH_BANANA_INFO_OPP	対戦相手のデッキはランダムなカードで組まれてるぞ。相手のミニオンが死ぬ度に、相手はバナナを1本手に入れるんだ。 	
TB_100TH_BANANA_INFO_YOU	あんたのデッキはランダムなカードで組まれてるぞ。あんたのミニオンが死ぬ度に、あんたはバナナを1本手に入れるんだ。 	
TB_100TH_BANANA_OPP	対戦相手は2015年6月24日に初登場した2番目の酒場の喧嘩「バナナ・バトル！」のルールでプレイしてるぞ。	
TB_100TH_BANANA_YOU	あんたは2015年6月24日に初登場した2番目の酒場の喧嘩「バナナ・バトル！」のルールでプレイしてるぞ。	
TB_100TH_CLONEBALL_INFO_OPP	対戦相手のデッキはそれぞれ複数枚コピーされた、数種類のランダムなレジェンドカードで組まれてるぞ。 	
TB_100TH_CLONEBALL_INFO_YOU	あんたのデッキはそれぞれ複数枚コピーされた、数種類のランダムなレジェンドカードで組まれてるぞ。 	
TB_100TH_CLONEBALL_OPP	対戦相手は2016年6月8日に初登場した52番目の酒場の喧嘩「クローンボール！」のルールでプレイしてるぞ。	
TB_100TH_CLONEBALL_YOU	あんたは2016年6月8日に初登場した52番目の酒場の喧嘩「クローンボール！」のルールでプレイしてるぞ。	
TB_100TH_PARTYPORTAL_INFO_OPP	このプレイヤーのデッキはランダムなポータルカードで組まれてるぞ。 	
TB_100TH_PARTYPORTAL_INFO_YOU	このプレイヤーのデッキはランダムなポータルカードで組まれてるぞ。 	
TB_100TH_PARTYPORTAL_OPP	対戦相手は2016年8月31日に初登場した64番目の酒場の喧嘩「パーティのポータル！」のルールでプレイしてるぞ。	
TB_100TH_PARTYPORTAL_YOU	あんたは2016年8月31日に初登場した64番目の酒場の喧嘩「パーティのポータル！」のルールでプレイしてるぞ。	
TB_100TH_PORTALS_INFO_OPP	対戦相手のデッキのほとんどは「不安定なポータル」で、別のカードが数枚入ってるぞ。 	
TB_100TH_PORTALS_INFO_YOU	あんたのデッキのほとんどは「不安定なポータル」で、別のカードが数枚入ってるぞ。 	
TB_100TH_PORTALS_OPP	対戦相手は2015年7月29日に初登場した7番目の酒場の喧嘩「ポータルだらけ！」のルールでプレイしてるぞ。	
TB_100TH_PORTALS_YOU	あんたは2015年7月29日に初登場した7番目の酒場の喧嘩「ポータルだらけ！」のルールでプレイしてるぞ。	
TB_100TH_RANDEMONIUM_INFO_OPP	対戦相手のデッキはランダムなカードで組まれてて、コストが毎ターン変化するぞ。 	
TB_100TH_RANDEMONIUM_INFO_YOU	あんたのデッキはランダムなカードで組まれてて、コストが毎ターン変化するぞ。 	
TB_100TH_RANDOMONIUM_OPP	対戦相手は2015年10月14日に初登場した18番目の酒場の喧嘩「ランダム地獄の一丁目」のルールでプレイしてるぞ。	
TB_100TH_RANDOMONIUM_YOU	あんたは2015年10月14日に初登場した18番目の酒場の喧嘩「ランダム地獄の一丁目」のルールでプレイしてるぞ。	
TB_100TH_RAVENIDOL_INFO_OPP	対戦相手のデッキは30枚の「ワタリガラスの偶像」で組まれてるぞ。 	
TB_100TH_RAVENIDOL_INFO_YOU	あんたのデッキは30枚の「ワタリガラスの偶像」で組まれてるぞ。 	
TB_100TH_RAVENIDOL_OPP	対戦相手は2016年4月20日に初登場した45番目の酒場の喧嘩「アゼロスの偶像」のルールでプレイしてるぞ。	
TB_100TH_RAVENIDOL_YOU	あんたは2016年4月20日に初登場した45番目の酒場の喧嘩「アゼロスの偶像」のルールでプレイしてるぞ。	
TB_100TH_SHIFTER_INFO_OPP	対戦相手のデッキのほとんどは「変身者ゼラス」で、別のカードが数枚入ってるぞ。 	
TB_100TH_SHIFTER_INFO_YOU	あんたのデッキのほとんどは「変身者ゼラス」で、別のカードが数枚入ってるぞ。 	
TB_100TH_SHIFTER_OPP	対戦相手は2016年6月29日に初登場した55番目の酒場の喧嘩「変身者コンベンション」のルールでプレイしてるぞ。	
TB_100TH_SHIFTER_YOU	あんたは2016年6月29日に初登場した55番目の酒場の喧嘩「変身者コンベンション」のルールでプレイしてるぞ。	
TB_100TH_SPELLBAG_INFO_OPP	対戦相手のデッキは30枚のランダムな呪文で組まれてて、それらを使うとミニオンも召喚されるぞ。 	
TB_100TH_SPELLBAG_INFO_YOU	あんたのデッキは30枚のランダムな呪文で組まれてて、それらを使うとミニオンも召喚されるぞ。 	
TB_100TH_SPELLBAG_OPP	対戦相手は2016年11月23日に初登場した76番目の酒場の喧嘩「ヴァリーラのお宝呪文袋」のルールでプレイしてるぞ。	
TB_100TH_SPELLBAG_YOU	あんたは2016年11月23日に初登場した76番目の酒場の喧嘩「ヴァリーラのお宝呪文袋」のルールでプレイしてるぞ。	
TB_100TH_YOGG_INFO_OPP	対戦相手のデッキは30枚のランダムなミニオンで組まれてて、それらを使うとランダムな呪文も使用されるぞ。 	
TB_100TH_YOGG_INFO_YOU	あんたのデッキは30枚のランダムなミニオンで組まれてて、それらを使うとランダムな呪文も使用されるぞ。 	
TB_100TH_YOGG_OPP	対戦相手は2016年7月13日に初登場した57番目の酒場の喧嘩「”ヨグ＝サロンの下僕”をお試し」のルールでプレイしてるぞ。	
TB_100TH_YOGG_YOU	あんたは2016年7月13日に初登場した57番目の酒場の喧嘩「”ヨグ＝サロンの下僕”をお試し」のルールでプレイしてるぞ。	
TB_DECKBUILDING_FIRSTCARDPLAYED	カードを使う度、そのカードのコピー1枚が自分のデッキのランダムな位置に追加されるぞ。	
TB_DECKBUILDING_FIRSTENDTURN	今度は、手札をデッキに戻して、引き直しだ。	
TB_DECKBUILDING_FIRSTPICKTHREE	手札にしたい新しいカードを1枚選んでくれ。	
TB_DECKBUILDING_STARTOFGAME	プレイしながらチームを作るんだ！幸運を祈る！	
TB_DECKBUILDING_STARTOFGAME_START	対戦開始！	
TB_DECKRECIPE_MSG_DRUID	デッキレシピ: <b>翡翠蓮のゴーレム</b>。	
TB_DECKRECIPE_MSG_HUNTER	デッキレシピ: <b>野獣軍団</b>。	
TB_DECKRECIPE_MSG_MAGE	デッキレシピ: <b>カバールのカクテル</b>。	
TB_DECKRECIPE_MSG_PALADIN	デッキレシピ: <b>闇市</b>。	
TB_DECKRECIPE_MSG_PRIEST	デッキレシピ: <b>ドラゴンハート</b>。	
TB_DECKRECIPE_MSG_ROGUE	デッキレシピ: <b>ガジェッツァンの波止場</b>。	
TB_DECKRECIPE_MSG_SHAMAN	デッキレシピ: <b>マーロック共同組合</b>。	
TB_DECKRECIPE_MSG_WARLOCK	デッキレシピ: <b>カバールの悪魔</b>。	
TB_DECKRECIPE_MSG_WARRIOR	デッキレシピ: <b>グーンズ帝国</b>。	
TB_DECKRECIPE_OG_DRUID	ドルイドのマナ生成呪文を駆使して、予言の日よりも早く旧神の下僕を召喚するぞ。  	
TB_DECKRECIPE_OG_HUNTER	ヒーローよ、死を恐れるな。あんたのミニオンは生きてても、死んでも役に立つ。迷わず敵のミニオンと相討ちさせるんだ。どんどんあんたが有利になるぞ。	
TB_DECKRECIPE_OG_MAGE	とにかくたくさん呪文を使うんだ。その一つ一つが、ヨグ＝サロンの目覚めの糧になるぞ！	
TB_DECKRECIPE_OG_PALADIN	味方のミニオンを「聖なる盾」で守り、相手のミニオンを2体ずつ倒させよう！	
TB_DECKRECIPE_OG_PRIEST	ミニオンを回復して長生きさせよう、恐るべきクトゥーンの目覚めを目撃するまでは！	
TB_DECKRECIPE_OG_ROGUE	積極的にミニオンを特攻させよう！死ぬ時に能力を発揮する連中が揃ってるぞ。勝利への生贄を積み上げよう。	
TB_DECKRECIPE_OG_SHAMAN	できるだけ多くのミニオンを召喚して、それから進化させよう！力を使い果たしたミニオンを進化させることで、最大限の力を引き出せるぞ！	
TB_DECKRECIPE_OG_WARLOCK	旧神の無数の手先をあんたの軍団に加えて強化しよう。小型ミニオンの大群で盤上を支配し、相手を圧倒しよう。	
TB_DECKRECIPE_OG_WARRIOR	我が身を守りつつ、クトゥーンへの祈祷を重ねるんだ。十分に装甲を重ねれば、旧神の力の前に敵はなすすべがなくなるぞ！	
TB_DPROMO_2NDHERO	牛王	
TB_DPROMO_2NDHEROPOPUP	隠しレベルにたどり着いたぞ！	
TB_DPROMO_COWKINGEMOTES	モー	
TB_GIFTEXCHANGE_GIFTSPAWNED	あんたの陣地に箱がなくなると、新しい箱が届くぞ。	
TB_GIFTEXCHANGE_GIFTSTOLEN	贈り物を手に入れたぞ！中身はなんだろうな…	
TB_GIFTEXCHANGE_START	冬至祭おめでとう！贈り物を手に入れろ！	
TB_LETHALPUZZLES_START	毎ラウンド、対戦相手を倒さなきゃならないぞ…幸運を祈る！	
TB_LETHALPUZZLES_SUCCESS	お見事！	
TB_MP_BOSS	飾られたストームウィンド	
TB_MP_BOSS2	パーティの町	
TB_MP_BOSS3	パーティの都	
TB_MP_COOP_1STSPELL	おおっと、カバールがフルーツパンチに何か入れたのかもな…	
TB_MP_COOP_2NDSPELL	おい、酒場の中で花火するのは勘弁してくれ！	
TB_MP_COOP_CRASHER_DISCARD	パーティクラッシャーはプレイヤーの手札で待ってるのに飽きて、出掛けちまったぞ。	
TB_MP_COOP_ENDING	おかげさまで、マンモス年のお祝いは大成功だ！ありがとうよ！	
TB_MP_COOP_FIRST_CRASHER	気を付けろ！ヤツらはパーティをぶち壊そうとしてるんだ。叩き出してくれ！	
TB_MP_COOP_PINATA	お見事！さあ、ピニャータ割りだ！だが、パーティクラッシャーどもが手に負えなくなってきたぞ…	
TB_MP_COOP_TEXT_START	相手プレイヤーと協力して、ヒーローパワーを使い酒場の飾り付けをしてくれ！ 	
TB_MP_CROSSROADS	ちょっと待った、あいつは誰だ？	
TB_MP_CROSSROADS_CRASHER	一体ここで何をしてるんだ？	
TB_MP_STORMWIND_SUCCESS	やったな！この先どこまで行けるかな？	
TB_PICKYOURFATE_BUILDAROUND_FIRSTFATE	選ばれた運命はプレイヤー両方に効果があるぞ！	
TB_PICKYOURFATE_BUILDAROUND_NEWFATE	いいか、このボーナスはあんただけのものだ。	
TB_PICKYOURFATE_BUILDAROUND_OPPONENT_FIRSTFATE	対戦相手の運命は、あんたにも効果があるぞ！	
TB_PICKYOURFATE_BUILDAROUND_OPPONENTFATE	いいか、このボーナスは対戦相手だけのものだ。	
TB_PICKYOURFATE_RANDOM_FIRSTFATE	選ばれた運命はプレイヤー両方に効果があるぞ！	
TB_PICKYOURFATE_RANDOM_NEWFATE	新たな運命を占おう！	
TB_PICKYOURFATE_RANDOM_OPPONENTFATE	対戦相手が新たな運命を占うぞ！	
TB_SHADOWTOWERS_ADJACENTMINIONS	塔に隣接するミニオンは<b>隠れ身</b>を得て、攻撃できなくなる。	
TB_SHADOWTOWERS_SHADOWSPAWNED	塔が無くなった側の陣営には、新しい塔が召喚されるぞ。	
TB_SHADOWTOWERS_SHADOWSPAWNEDNEXT	自分の陣地の塔が無くなると、次の自分のターンの開始時に新しい塔が現れるぞ。	
