TAG	TEXT	COMMENT
GLOBAL_ADDFRIEND_ERROR_ALREADY_FRIEND	Ya está en tu lista de amigos.	
GLOBAL_ADDFRIEND_ERROR_MALFORMED	Tienes que introducir una dirección de correo electrónico o una BattleTag.	
GLOBAL_ADDFRIEND_HEADER	Añadir amigo	
GLOBAL_ADDFRIEND_INSTRUCTION	Introduce una dirección de correo electrónico o BattleTag.	
GLOBAL_ADDFRIEND_SENT_CONFIRMATION	Solicitud de amistad enviada.	
GLOBAL_ATTACK	Ataque	
GLOBAL_BACK	Atrás	
GLOBAL_BETA_REIMBURSEMENT_DETAILS	Este oro es crédito por tus compras anteriores. ¡Muchas gracias!	
GLOBAL_BETA_REIMBURSEMENT_HEADLINE	Crédito por reinicio de cuentas	
GLOBAL_BUTTON_NO	No	
GLOBAL_BUTTON_OK	Aceptar	
GLOBAL_BUTTON_YES	Sí	
GLOBAL_CANCEL	Cancelar	
GLOBAL_CARD_SET_CORE	Básico	
GLOBAL_CARD_SET_EXPERT1	Experto	
GLOBAL_CARD_SET_PROMO	Promoción	
GLOBAL_CARD_SET_REWARD	Recompensa	
GLOBAL_CARDTYPE_ENCHANTMENT	Encantamiento	
GLOBAL_CARDTYPE_HERO	Héroe	
GLOBAL_CARDTYPE_HEROPOWER	Poder de héroe	
GLOBAL_CARDTYPE_ITEM	Objeto	
GLOBAL_CARDTYPE_MINION	Esbirro	
GLOBAL_CARDTYPE_SPELL	Hechizo	
GLOBAL_CARDTYPE_TOKEN	Ficha	
GLOBAL_CARDTYPE_WEAPON	Arma	
GLOBAL_CHAT_BUBBLE_RECEIVER_NAME	Para: {0}	0=player name
GLOBAL_CHAT_CHALLENGE	Desafío	
GLOBAL_CHAT_NO_FRIENDS_ONLINE	No hay amigos conectados ahora mismo.	
GLOBAL_CHAT_NO_RECENT_CONVERSATIONS	Usa el menú de amigos para iniciar una conversación con un amigo.	
GLOBAL_CHAT_RECEIVER_OFFLINE	{0} está desconectado.	0=player name
GLOBAL_CHAT_RECEIVER_ONLINE	{0} está conectado.	0=player name
GLOBAL_CLASS_DEATHKNIGHT	Caballero de la Muerte	
GLOBAL_CLASS_DRUID	Druida	
GLOBAL_CLASS_HUNTER	Cazador	
GLOBAL_CLASS_MAGE	Mago	
GLOBAL_CLASS_NEUTRAL	Neutral	
GLOBAL_CLASS_PALADIN	Paladín	
GLOBAL_CLASS_PRIEST	Sacerdote	
GLOBAL_CLASS_ROGUE	Pícaro	
GLOBAL_CLASS_SHAMAN	Chamán	
GLOBAL_CLASS_WARLOCK	Brujo	
GLOBAL_CLASS_WARRIOR	Guerrero	
GLOBAL_CLICK_TO_CONTINUE	Haz clic para continuar	
GLOBAL_COLLECTION_GOLDEN	dorada	
GLOBAL_CONCEDE	Rendirse	
GLOBAL_CONFIRM	Confirmar	
GLOBAL_COST	Coste	
GLOBAL_CURRENT_TIME	{0:HH:mm}	see http://msdn.microsoft.com/en-us/library/8kb3ddd4.aspx
GLOBAL_DATETIME_FRIENDREQUEST_DAY	ayer	
GLOBAL_DATETIME_FRIENDREQUEST_DAYS	Hace {0} |4(día,días)	
GLOBAL_DATETIME_FRIENDREQUEST_HOURS	Hace {0} |4(hora,horas)	
GLOBAL_DATETIME_FRIENDREQUEST_MINUTES	Hace {0} |4(minuto,minutos)	
GLOBAL_DATETIME_FRIENDREQUEST_MONTH	hace más de un mes	
GLOBAL_DATETIME_FRIENDREQUEST_SECONDS	hace menos de un minuto	
GLOBAL_DATETIME_FRIENDREQUEST_WEEKS	Hace {0} |4(semana,semanas)	
GLOBAL_DATETIME_LASTONLINE_DAY	se conectó ayer	
GLOBAL_DATETIME_LASTONLINE_DAYS	se conectó hace {0} |4(día,días)	
GLOBAL_DATETIME_LASTONLINE_HOURS	se conectó hace {0} |4(hora,horas)	
GLOBAL_DATETIME_LASTONLINE_MINUTES	se conectó hace {0} |4(minuto,minutos)	
GLOBAL_DATETIME_LASTONLINE_MONTH	se conectó hace más de un mes	
GLOBAL_DATETIME_LASTONLINE_SECONDS	se conectó hace menos de un minuto	
GLOBAL_DATETIME_LASTONLINE_WEEKS	se conectó hace {0} |4(semana,semanas)	
GLOBAL_DATETIME_SPLASHSCREEN_DAY	> 1 día	
GLOBAL_DATETIME_SPLASHSCREEN_DAYS	{0} |4(día,días)	
GLOBAL_DATETIME_SPLASHSCREEN_HOURS	{0} |4(hora,horas)	
GLOBAL_DATETIME_SPLASHSCREEN_MINUTES	{0} |4(minuto,minutos)	
GLOBAL_DATETIME_SPLASHSCREEN_MONTH	> 1 mes	
GLOBAL_DATETIME_SPLASHSCREEN_SECONDS	< 1 min	
GLOBAL_DATETIME_SPLASHSCREEN_WEEKS	{0} |4(semana,semanas)	
GLOBAL_DEFAULT_ALERT_HEADER	Aviso	
GLOBAL_DONE	Listo	
GLOBAL_ERROR_ASSET_CREATE_PERSISTENT_DATA_PATH	No se ha podido crear una carpeta para guardar datos en {0}.	0=folder path
GLOBAL_ERROR_ASSET_DOWNLOAD_FAILED	No se ha podido descargar el elemento {0}.	0=asset name
GLOBAL_ERROR_ASSET_INCORRECT_DATA	El elemento {0} contiene datos incorrectos.	0=asset name
GLOBAL_ERROR_ASSET_LOAD_FAILED	Error al cargar el elemento {0}.	0=asset name
GLOBAL_ERROR_ASSET_NO_FILE_PATH	No se ha podido encontrar una ruta de archivo para el elemento {0}.	0=asset name
GLOBAL_ERROR_CURRENCY_INVALID	El cliente ha intentado utilizar una moneda no válida para realizar una transacción.	
GLOBAL_ERROR_GAME_DENIED	Se ha producido un error al iniciar tu partida. Espera unos minutos y vuelve a intentarlo.	
GLOBAL_ERROR_GAME_OPPONENT_TIMEOUT	No se ha podido iniciar la partida porque tu oponente no se ha conectado. Vuelve a intentarlo.	
GLOBAL_ERROR_GENERIC_HEADER	Error	
GLOBAL_ERROR_INACTIVITY_KICK	Se ha cancelado la conexión porque llevas demasiado tiempo inactivo en Hearthstone. Inicia el juego cuando quieras continuar.	
GLOBAL_ERROR_NETWORK_ACCOUNT_BANNED	Se ha suspendido permanentemente tu cuenta.	
GLOBAL_ERROR_NETWORK_ACCOUNT_SUSPENDED	Tu cuenta ha sido suspendida.	
GLOBAL_ERROR_NETWORK_PARENTAL_CONTROLS	Access to this account is currently restricted by parental controls.	
GLOBAL_ERROR_NETWORK_DISCONNECT	Se te ha desconectado del servicio de Battle.net. Vuelve a iniciar Hearthstone para volver a conectarte.	
GLOBAL_ERROR_NETWORK_DUPLICATE_LOGIN	Esta cuenta de Battle.net acaba de iniciar sesión en Hearthstone desde otro dispositivo.\n\nEste cliente se ha desconectado porque una misma cuenta solo puede tener iniciada una sesión.	
GLOBAL_ERROR_NETWORK_GENERIC	Se ha producido un error de red interno.	
GLOBAL_ERROR_NETWORK_INCORRECT_REGION	Esta cuenta de Battle.net no puede optar a participar en la prueba beta de Hearthstone de esta región. ¡Vuelve a intentarlo cuando la beta de Hearthstone esté disponible en tu región!	
GLOBAL_ERROR_NETWORK_LOGIN_FAILURE	El juego no ha podido iniciar tu sesión en Battle.net. Espera unos minutos y vuelve a intentarlo.	
GLOBAL_ERROR_NETWORK_LOST_GAME_CONNECTION	Tu partida se ha desconectado del servicio de juego de Battle.net. Puedes intentar volver a conectarte iniciando otra partida.	
GLOBAL_ERROR_NETWORK_SPAM	Se te ha desconectado del servicio de Battle.net por enviar demasiadas solicitudes demasiado rápido. Vuelve a iniciar Hearthstone para volver a conectarte.	
GLOBAL_ERROR_NETWORK_TITLE	ERROR DE RED	
GLOBAL_ERROR_NETWORK_UTIL_TIMEOUT	Se ha agotado el tiempo de espera de tu partida mientras solicitaba datos de los servicios básicos de Hearthstone. Vuelve a iniciar Hearthstone para volver a conectarte.	
GLOBAL_ERROR_STREAMING_ASSET_TIMEOUT	Se ha agotado el tiempo de espera del sistema de transmisión. Se estaba cargando el elemento {0}.	0=asset name
GLOBAL_ERROR_UNKNOWN_ERROR	¡Vaya! Unos duendes traviesos han interrumpido Hearthstone cuando estaba conectándose al servicio de Battle.net. Espera unos minutos a que se vayan y prueba a ejecutar el juego de nuevo.	
GLOBAL_EXIT	Salir	
GLOBAL_FEATURE_DISABLED_MESSAGE_COLLECTION	Lo sentimos, la Colección no está activa en este momento.	
GLOBAL_FEATURE_DISABLED_MESSAGE_FORGE	Lo sentimos, la Arena no está activa en este momento.	
GLOBAL_FEATURE_DISABLED_MESSAGE_PLAY	Lo sentimos, el modo Jugar no está activo en este momento.	
GLOBAL_FEATURE_DISABLED_MESSAGE_PRACTICE	Lo sentimos, el modo Práctica no está activo en este momento.	
GLOBAL_FEATURE_DISABLED_TITLE	Desactivado	
GLOBAL_FORGE_END_DONE	Listo	
GLOBAL_FORGE_END_JOKE_0	¡Ha sido sublime!	
GLOBAL_FORGE_END_JOKE_1	¡No tengo palabras!	
GLOBAL_FORGE_END_JOKE_2	¡No me lo puedo creer!	
GLOBAL_FORGE_END_JOKE_3	Tienes algo realmente especial.	
GLOBAL_FORGE_END_JOKE_4	¿Serás capaz de mejorarlo?	
GLOBAL_FORGE_END_JOKE_5	¡Ha sido magnífico!	
GLOBAL_FORGE_END_JOKE_6	¡Ese turno de antes fue espectacular!	
GLOBAL_FORGE_END_JOKE_7	¡OBSERVA!	
GLOBAL_FORGE_END_JOKE_8	¡Esto no acaba aquí! Ah, no, sí que acaba aquí.	
GLOBAL_FORGE_END_TITLE	Arena completada	
GLOBAL_FRIEND_CHALLENGE_ACCEPT	¡Sí!	
GLOBAL_FRIEND_CHALLENGE_DECLINE	No	
GLOBAL_FRIEND_CHALLENGE_HEADER	Desafío	
GLOBAL_FRIEND_CHALLENGE_OPPONENT_CANCELED	{0} ha cancelado el desafío.	0=friend name
GLOBAL_FRIEND_CHALLENGE_OPPONENT_DECLINED	{0} ha rechazado tu desafío.	0=friend name
GLOBAL_FRIEND_CHALLENGE_OPPONENT_FRIEND_REMOVED	Desafío cancelado porque {0} ya no es tu amigo.	0=friend name
GLOBAL_FRIEND_CHALLENGE_OPPONENT_WAITING_DECK	Esperas a que {0} elija un mazo.	0=friend name
GLOBAL_FRIEND_CHALLENGE_OPPONENT_WAITING_RESPONSE	Esperas a que {0} responda a tu desafío.	0=friend name
GLOBAL_FRIEND_CHALLENGE_RECEIVED	{0} te ha desafiado.\n\n¿Aceptas?	0=friend name
GLOBAL_FRIEND_CHALLENGE_TITLE	Amistoso	
GLOBAL_FRIENDLIST_ADD_FRIEND_BUTTON	Añadir	
GLOBAL_FRIENDLIST_CURRENT_GAMES_HEADER	PARTIDAS ACTUALES - {0}	0=number of friends you have unfinished games with
GLOBAL_FRIENDLIST_FRIENDS_HEADER	AMIGOS - {0}/{1} |4(conectado,conectados)	0=number of online friends 1=number of offline friends
GLOBAL_FRIENDLIST_FRIENDS_HEADER_ALL_ONLINE	AMIGOS - {0} |4(conectado,conectados)	
GLOBAL_FRIENDLIST_FRIENDS_HEADER_NO_ONLINE	AMIGOS	
GLOBAL_FRIENDLIST_MYSTATUS	CONECTADO	
GLOBAL_FRIENDLIST_REMOVE_FRIEND_ALERT_MESSAGE	¿Seguro que quieres eliminar a {0}?	0=friend name
GLOBAL_FRIENDLIST_REMOVE_FRIEND_BUTTON	Eliminar	
GLOBAL_FRIENDLIST_REQUEST_SENT_TIME	Enviada: {0}	0=one of the GLOBAL_DATETIME_ELAPSED_ strings
GLOBAL_FRIENDLIST_REQUESTS_HEADER	SOLICITUDES DE AMISTAD - {0}	0=number of received friend requests
GLOBAL_GAME_MENU	Menú del juego	
GLOBAL_HEALTH	Salud	
GLOBAL_HEALTHY_GAMING_CHINA_LESS_THAN_THREE_HOURS	您累计在线时间已满{0}小时。	
GLOBAL_HEALTHY_GAMING_CHINA_MORE_THAN_FIVE_HOURS	您已进入不健康游戏时间，为了您的健康，请您立即下线休息。如不下线，您的身体将受到损害，您的收益已降为零，直到您的累计下线时间满5小时后，才能恢复正常。	
GLOBAL_HEALTHY_GAMING_CHINA_THREE_HOURS	您累计在线时间已满{0}小时，请您下线休息，做适当身体活动。	
GLOBAL_HEALTHY_GAMING_CHINA_THREE_TO_FIVE_HOURS	您已经进入疲劳游戏时间，您的游戏收益将降为正常值的0%，为了您的健康，请尽快下线休息，做适当身体活动，合理安排学习生活。	
GLOBAL_HEALTHY_GAMING_KOREA_STARTUP_MESSAGE	본 게임물은 만 12세 이용가 게임으로서 해당 연령 미만의 청소년이 이용하기에 부적절합니다. 반드시 보호자의 지도 감독이 필요합니다.	
GLOBAL_HEALTHY_GAMING_TOAST	게임을 플레이한지 {0}시간 지났습니다. 과도한 게임이용은 정상적인 일상생활에 지장을 줄 수 있습니다	
GLOBAL_HEALTHY_GAMING_TOAST_OVER_THRESHOLD	Llevas {0} |4(hora,horas) jugando. Es muchísimo tiempo.	0=hours
GLOBAL_HERO_LEVEL_NEXT_REWARD_TITLE	Siguiente recompensa: nivel {0}	0=level
GLOBAL_HERO_LEVEL_REWARD_ARCANE_DUST	{0} p. de polvo Arcano	0=amount
GLOBAL_HERO_LEVEL_REWARD_BOOSTER	Sobre {0}	0=booster type
GLOBAL_HERO_LEVEL_REWARD_GOLD	{0} oro	0=amount
GLOBAL_HERO_LEVEL_REWARD_GOLDEN_CARD	{1} {0}	0=flair 1=card name
GLOBAL_KEYWORD_BATTLECRY	Grito de batalla	
GLOBAL_KEYWORD_BATTLECRY_TEXT	Esta carta hace algo al jugarla desde tu mano.	
GLOBAL_KEYWORD_CHARGE	Cargar	
GLOBAL_KEYWORD_CHARGE_TEXT	Puede atacar inmediatamente.	
GLOBAL_KEYWORD_COMBO	Combo	
GLOBAL_KEYWORD_COMBO_TEXT	Otorga un bonus si ya has jugado una carta este turno.	
GLOBAL_KEYWORD_COUNTER	Contrarrestar	
GLOBAL_KEYWORD_COUNTER_TEXT	Una carta contrarrestada no tiene efecto.	
GLOBAL_KEYWORD_DEATHRATTLE	Último aliento	
GLOBAL_KEYWORD_DEATHRATTLE_TEXT	Hace algo al morir.	
GLOBAL_KEYWORD_DIVINE_SHIELD	Escudo divino	
GLOBAL_KEYWORD_DIVINE_SHIELD_REF_TEXT	La primera vez que un esbirro con escudo recibe daño, lo ignora.	
GLOBAL_KEYWORD_DIVINE_SHIELD_TEXT	La primera vez que este esbirro recibe daño, lo ignora.	
GLOBAL_KEYWORD_ENRAGED	Enfurecer	
GLOBAL_KEYWORD_ENRAGED_TEXT	Mientras esté dañado, este esbirro tiene un poder nuevo.	
GLOBAL_KEYWORD_FREEZE	Congelación	
GLOBAL_KEYWORD_FREEZE_TEXT	Los personajes congelados fallan el siguiente ataque.	
GLOBAL_KEYWORD_FROZEN	Congelado	
GLOBAL_KEYWORD_FROZEN_TEXT	Pierde su siguiente ataque.	
GLOBAL_KEYWORD_IMMUNE	Inmune	
GLOBAL_KEYWORD_IMMUNE_REF_TEXT	No se puede dañar a los personajes inmunes.	
GLOBAL_KEYWORD_IMMUNE_TEXT	No se puede dañar.	
GLOBAL_KEYWORD_RECALL	Sobrecarga: X	
GLOBAL_KEYWORD_RECALL_TEXT	Tienes X cristales menos de maná en el siguiente turno.	
GLOBAL_KEYWORD_SECRET	Secreto	
GLOBAL_KEYWORD_SECRET_TEXT	Oculto hasta que se realiza una acción concreta.	
GLOBAL_KEYWORD_SILENCE	Silencio	
GLOBAL_KEYWORD_SILENCE_TEXT	Elimina todas las facultades de una carta.	
GLOBAL_KEYWORD_SPELLPOWER	Daño con hechizos	
GLOBAL_KEYWORD_SPELLPOWER_TEXT	Tus cartas de hechizos infligen {0} p. de daño extra.	0=amount of spell damage
GLOBAL_KEYWORD_STEALTH	Sigilo	
GLOBAL_KEYWORD_STEALTH_REF_TEXT	No se puede atacar ni seleccionar como objetivo hasta que inflige daño.	
GLOBAL_KEYWORD_STEALTH_TEXT	No se puede atacar ni seleccionar como objetivo hasta que inflige daño.	
GLOBAL_KEYWORD_TAUNT	Provocar	
GLOBAL_KEYWORD_TAUNT_REF_TEXT	Los enemigos deben atacar a los esbirros que tengan Provocar.	
GLOBAL_KEYWORD_TAUNT_TEXT	Los enemigos deben atacar a este esbirro.	
GLOBAL_KEYWORD_WINDFURY	Viento Furioso	
GLOBAL_KEYWORD_WINDFURY_TEXT	Puede atacar dos veces cada turno.	
GLOBAL_LOGOUT	Desconectarse	
GLOBAL_LOSSES	Pérdidas	
GLOBAL_MEDAL_APPRENTICE	Aprendiz	for Arena only
GLOBAL_MEDAL_COPPER	Cobre	
GLOBAL_MEDAL_DIAMOND	Diamante	
GLOBAL_MEDAL_GOLD	Oro	
GLOBAL_MEDAL_GRANDMASTER	Gran maestro	
GLOBAL_MEDAL_JOURNEYMAN	Oficial	
GLOBAL_MEDAL_MASTER	Maestro	
GLOBAL_MEDAL_NO_NAME	No	
GLOBAL_MEDAL_NOVICE	Novato	
GLOBAL_MEDAL_ONE_STAR	★	
GLOBAL_MEDAL_PLATINUM	Platino	
GLOBAL_MEDAL_REWARD_CONGRATULATIONS	¡Felicidades!	
GLOBAL_MEDAL_REWARD_DESCRIPTION	Medalla ganada la semana pasada	
GLOBAL_MEDAL_SILVER	Plata	
GLOBAL_MEDAL_STARRED_FORMAT	{1} {0}	0=star leve1, 1=medal type
GLOBAL_MEDAL_THREE_STAR	★★★	
GLOBAL_MEDAL_TOOLTIP_BODY	¡Gana partidas para alcanzar la siguiente medalla!\n\nSiguiente medalla:\n{0}	0=medal name
GLOBAL_MEDAL_TOOLTIP_BODY_ARENA_GRAND_MASTER	¡Has triunfado en la Arena!	
GLOBAL_MEDAL_TOOLTIP_HEADER	Medalla: {0}	0=medal name
GLOBAL_MEDAL_TWO_STAR	★★	
GLOBAL_MY_NUM_WINS	{0}	0=number of games this player has won
GLOBAL_OFFLINE	Desconectado	
GLOBAL_OKAY	Aceptar	
GLOBAL_OPTIONS	Opciones	
GLOBAL_OPTIONS_CARDBACK_LABEL	Elige el dorso de tus cartas	
GLOBAL_OPTIONS_CINEMATIC	Escena de vídeo	
GLOBAL_OPTIONS_CREDITS	Créditos	
GLOBAL_OPTIONS_GRAPHICS_FULLSCREEN_LABEL	Pantalla completa	
GLOBAL_OPTIONS_GRAPHICS_LABEL	Gráficos	
GLOBAL_OPTIONS_GRAPHICS_QUALITY_HIGH	Alta	
GLOBAL_OPTIONS_GRAPHICS_QUALITY_LABEL	Calidad	
GLOBAL_OPTIONS_GRAPHICS_QUALITY_LOW	Baja	
GLOBAL_OPTIONS_GRAPHICS_QUALITY_MEDIUM	Media	
GLOBAL_OPTIONS_GRAPHICS_RESOLUTION_LABEL	Resolución	
GLOBAL_OPTIONS_MISCELLANEOUS_LABEL	Miscelánea	
GLOBAL_OPTIONS_PUBLIC_CHAT_ENABLED	Chat hostil	
GLOBAL_OPTIONS_SOUND_IN_BACKGROUND	Sonido en segundo plano	
GLOBAL_OPTIONS_SOUND_LABEL	Sonido	
GLOBAL_OPTIONS_SOUND_MASTER_VOLUME_LABEL	Volumen general	
GLOBAL_OPTIONS_SOUND_MUSIC_VOLUME_LABEL	Volumen de la música	
GLOBAL_PLAY	Jugar	
GLOBAL_PRACTICE_MAX_LEVEL_REACHED	Nivel máximo en modo Práctica	
GLOBAL_PROGRAMNAME_DIABLO3	Diablo 3	
GLOBAL_PROGRAMNAME_HEARTHSTONE	Hearthstone	
GLOBAL_PROGRAMNAME_PHOENIX	Battle.net	
GLOBAL_PROGRAMNAME_STARCRAFT2	StarCraft II	
GLOBAL_PROGRAMNAME_WOW	World of Warcraft	
GLOBAL_QUEST_PROGRESS_COUNT	{0}/{1}	0=progress,1=max progress
GLOBAL_QUIT	Salir	
GLOBAL_RACE_BLOODELF	Elfo de sangre	
GLOBAL_RACE_DEMON	Demonio	
GLOBAL_RACE_DRAENEI	Draenei	
GLOBAL_RACE_DRAGON	Dragón	
GLOBAL_RACE_DWARF	Enano	
GLOBAL_RACE_ELEMENTAL	Elemental	
GLOBAL_RACE_GNOME	Gnomo	
GLOBAL_RACE_GOBLIN	Goblin	
GLOBAL_RACE_HUMAN	Humano	
GLOBAL_RACE_MECHANICAL	Mecánico	
GLOBAL_RACE_MURLOC	Múrloc	
GLOBAL_RACE_NERUBIAN	Nerubiano	
GLOBAL_RACE_NIGHTELF	Elfo de la noche	
GLOBAL_RACE_OGRE	Ogro	
GLOBAL_RACE_ORC	Orco	
GLOBAL_RACE_PET	Bestia	
GLOBAL_RACE_PIRATE	Pirata	
GLOBAL_RACE_SCOURGE	Plaga	
GLOBAL_RACE_TAUREN	Tauren	
GLOBAL_RACE_TOTEM	Tótem	
GLOBAL_RACE_TROLL	Trol	
GLOBAL_RACE_UNDEAD	No-muerto	
GLOBAL_RACE_WORGEN	Huargen	
GLOBAL_RARITY_COMMON	Común	
GLOBAL_RARITY_EPIC	Épica	
GLOBAL_RARITY_FREE	Gratuita	
GLOBAL_RARITY_LEGENDARY	Legendaria	
GLOBAL_RARITY_RARE	Poco común	
GLOBAL_RESUME_GAME	Continuar	
GLOBAL_REWARD_ARCANE_DUST_HEADLINE	¡Polvo Arcano obtenido!	
GLOBAL_REWARD_BOOSTER_HEADLINE	¡Sobre experto conseguido!	
GLOBAL_REWARD_CARD_COUNT_MULTIPLIER	x	
GLOBAL_REWARD_CARD_DETAILS_TUTORIAL01	¡Toma ya!	
GLOBAL_REWARD_CARD_DETAILS_TUTORIAL02	Ha sido impresionante.	
GLOBAL_REWARD_CARD_DETAILS_TUTORIAL03	¡Estás en racha!	
GLOBAL_REWARD_CARD_DETAILS_TUTORIAL04	Ha sido increíble.	
GLOBAL_REWARD_CARD_DETAILS_TUTORIAL05	¡Magnífico!	
GLOBAL_REWARD_CARD_DETAILS_TUTORIAL06	¡Alucinante!	
GLOBAL_REWARD_CARD_HEADLINE	¡Recompensa!	
GLOBAL_REWARD_CARD_LEVEL_UP	Se desbloquea al alcanzar el nivel {0} con el {1}	0=# level, 1=class
GLOBAL_REWARD_CORE_CARD_DETAILS	{0}/{1} cartas de {2} desbloqueadas	0=# cards unlocked, 1=# cards possible to unlock, 2=class
GLOBAL_REWARD_FORGE_UNLOCKED_HEADLINE	¡Arena desbloqueada!	
GLOBAL_REWARD_FORGE_UNLOCKED_SOURCE	Se otorga al entrar en la Arena	
GLOBAL_REWARD_GOLD_HEADLINE	¡Oro obtenido!	
GLOBAL_REWARD_GOLD_SOURCE_TOURNEY	Recompensa por ganar {0} |4(partida,partidas) en el modo Jugar	
GLOBAL_REWARD_GOLDEN_HERO_HEADLINE	{0} dorado desbloqueado	
GLOBAL_REWARD_HERO_DETAILS	{0}/{1} héroes desbloqueados	
GLOBAL_REWARD_HERO_HEADLINE	Has desbloqueado al {0}	
GLOBAL_REWARD_HERO_SOURCE	Se desbloquea al derrotar al {0}	0=class
GLOBAL_SCREENSHOT_COMPLETE	Captura de pantalla guardada en el escritorio	
GLOBAL_SET_CORE	Conjunto básico	
GLOBAL_SET_EXPERT1	Conjunto experto	
GLOBAL_SHUTDOWN_TOAST	<color=#{0}>Battle.net se cerrará en {1} min</color>	0=color, 1=minutes
GLOBAL_SOCIAL_TOAST_FRIEND_ARENA_COMPLETE	<color=#{0}>{1}</color> acaba de terminar una partida de Arena. ({2}-{3})	0=name color,1=player name,2=Arena Wins,3=Arena Losses
GLOBAL_SOCIAL_TOAST_FRIEND_ARENA_START	<color=#{0}>{1}</color> ha empezado una partida de Arena.	0=name color,1=player name
GLOBAL_SOCIAL_TOAST_FRIEND_GOLDEN_LEGENDARY	¡<color=#{0}>{1}</color> ha conseguido una carta <color=#{3}>{2} dorada</color>!	0=name color,1=player name,2=card name,3=Golden Color
GLOBAL_SOCIAL_TOAST_FRIEND_LEGENDARY	¡<color=#{0}>{1}</color> ha conseguido la carta <color=#{3}>{2}</color>!	0=name color,1=player name,2=card name
GLOBAL_SOCIAL_TOAST_FRIEND_OFFLINE	<color=#{0}>{1}</color> se ha desconectado.	0=name color,1=player name
GLOBAL_SOCIAL_TOAST_FRIEND_ONLINE	<color=#{0}>{1}</color> se ha conectado.	0=name color,1=player name
GLOBAL_SOCIAL_TOAST_FRIEND_REQUEST	<color=#{0}>{1}</color> te ha enviado una solicitud de amistad.	0=name color,1=player name
GLOBAL_SPLASH_CLOSED_SIGN_TITLE	Cerrado	
GLOBAL_TOOLTIP_MENU_DESC	Aquí puedes consultar las opciones, salir del juego y más.	
GLOBAL_TOOLTIP_MENU_HEADER	Menú del juego	
GLOBAL_WINS	Victorias	
GLOBAL_HEALTHY_GAMING_CHINA_CAIS_ACTIVE	CAIS Active	