TAG	TEXT	COMMENT
LOEA16_2_STAFF_TEXT_CHARGE_0	<b>被动英雄技能</b>\n你的英雄获得<b>免疫</b>，还有三个回合。	
LOEA16_2_STAFF_TEXT_CHARGE_1	<b>被动英雄技能</b>\n你的英雄获得<b>免疫</b>，还有两个回合。	
LOEA16_2_STAFF_TEXT_CHARGE_2	<b>被动英雄技能</b>\n你的英雄获得<b>免疫</b>，还有一个回合！	
LOEA16_2_STAFF_TEXT_CHARGE_EXPLODED	<b>被动英雄技能</b>\n召唤一个首领，但会失去<b>免疫</b>。	
MISSION_DEFAULTCOUNTERNAME	逃亡回合	
MISSION_GLOWING_POOL	发光的水池	
MISSION_NEFARIAN_TITLE	傻瓜、废物以及垃圾随从的克星	
MISSION_PIT_OF_SPIKES	钉刺陷阱	
MISSION_PRE_TUTORIAL_WANTED	缉拿	
MISSION_STATUES_EYE	雕像之眼	
MISSION_TAKE_THE_SHORTCUT	选择捷径？	
TB_100TH_BANANA_INFO_OPP	你对手的套牌由随机卡牌组成。每当对手的随从死亡时，他就会获得一根香蕉。	
TB_100TH_BANANA_INFO_YOU	你的套牌由随机卡牌组成。每当你的随从死亡时，你就会获得一根香蕉。	
TB_100TH_BANANA_OPP	你的对手使用的是第2场乱斗模式——香蕉大乱斗，该乱斗初次登场时间为2015年6月24日。	
TB_100TH_BANANA_YOU	你使用的是第2场乱斗模式——香蕉大乱斗，该乱斗初次登场时间为2015年6月24日。	
TB_100TH_CLONEBALL_INFO_OPP	你对手的套牌由随机传说卡牌组成，且每张牌有数个复制。	
TB_100TH_CLONEBALL_INFO_YOU	你的套牌由随机传说卡牌组成，且每张牌有数个复制。	
TB_100TH_CLONEBALL_OPP	你的对手使用的是第52场乱斗模式——克隆球大赛，该乱斗初次登场时间为2016年6月8日。	
TB_100TH_CLONEBALL_YOU	你使用的是第52场乱斗模式——克隆球大赛，该乱斗初次登场时间为2016年6月8日。	
TB_100TH_PARTYPORTAL_INFO_OPP	该玩家的套牌由随机传送门卡牌组成。	
TB_100TH_PARTYPORTAL_INFO_YOU	该玩家的套牌由随机传送门卡牌组成。	
TB_100TH_PARTYPORTAL_OPP	你的对手使用的是第64场乱斗模式——派对传送门，该乱斗初次登场时间为2016年8月31日。	
TB_100TH_PARTYPORTAL_YOU	你使用的是第64场乱斗模式——派对传送门，该乱斗初次登场时间为2016年8月31日。	
TB_100TH_PORTALS_INFO_OPP	你对手的套牌除了些许法术牌之外，其他都是不稳定的传送门。	
TB_100TH_PORTALS_INFO_YOU	你的套牌除了些许法术牌之外，其他都是不稳定的传送门。	
TB_100TH_PORTALS_OPP	你的对手使用的是第7场乱斗模式——遍地传送门，该乱斗初次登场时间为2015年7月29日。	
TB_100TH_PORTALS_YOU	你使用的是第7场乱斗模式——遍地传送门，该乱斗初次登场时间为2015年7月29日。	
TB_100TH_RANDEMONIUM_INFO_OPP	你对手的套牌由随机卡牌组成，其法力值消耗每个回合都是随机的。	
TB_100TH_RANDEMONIUM_INFO_YOU	你的套牌由随机卡牌组成，其法力值消耗每个回合都是随机的。	
TB_100TH_RANDOMONIUM_OPP	你的对手使用的是第18场乱斗模式——异乎寻常的法力风暴，该乱斗初次登场时间为2015年10月14日。	
TB_100TH_RANDOMONIUM_YOU	你使用的是第18场乱斗模式——异乎寻常的法力风暴，该乱斗初次登场时间为2015年10月14日。	
TB_100TH_RAVENIDOL_INFO_OPP	你对手的套牌由30张乌鸦神像组成。	
TB_100TH_RAVENIDOL_INFO_YOU	你的套牌由30张乌鸦神像组成。	
TB_100TH_RAVENIDOL_OPP	你的对手使用的是第45场乱斗模式——发现之旅，该乱斗初次登场时间为2016年4月20日。	
TB_100TH_RAVENIDOL_YOU	你使用的是第45场乱斗模式——发现之旅，该乱斗初次登场时间为2016年4月20日。	
TB_100TH_SHIFTER_INFO_OPP	你对手的套牌除了些许法术牌之外，其他都是百变泽鲁斯。	
TB_100TH_SHIFTER_INFO_YOU	你的套牌除了些许法术牌之外，其他都是百变泽鲁斯。	
TB_100TH_SHIFTER_OPP	你的对手使用的是第55场乱斗模式——我变我变我变变变，该乱斗初次登场时间为2016年6月29日。	
TB_100TH_SHIFTER_YOU	你使用的是第55场乱斗模式——我变我变我变变变，该乱斗初次登场时间为2016年6月29日。	
TB_100TH_SPELLBAG_INFO_OPP	你对手的套牌由30张随机法术牌组成，使用法术牌会随机召唤与其法力值消耗相同的一个随从。	
TB_100TH_SPELLBAG_INFO_YOU	你的套牌由30张随机法术牌组成，使用法术牌会随机召唤与其法力值消耗相同的一个随从。	
TB_100TH_SPELLBAG_OPP	你的对手使用的是第76场乱斗模式——瓦莉拉的小秘密，该乱斗初次登场时间为2016年11月23日。	
TB_100TH_SPELLBAG_YOU	你使用的是第76场乱斗模式——瓦莉拉的小秘密，该乱斗初次登场时间为2016年11月23日。	
TB_100TH_YOGG_INFO_OPP	你对手的套牌由随机随从牌组成，使用随从牌会随机施放一个法术。	
TB_100TH_YOGG_INFO_YOU	你的套牌由随机随从牌组成，使用随从牌会随机施放一个法术。	
TB_100TH_YOGG_OPP	你的对手使用的是第57场乱斗模式——古神试镜会，该乱斗初次登场时间为2016年7月13日。	
TB_100TH_YOGG_YOU	你使用的是第57场乱斗模式——古神试镜会，该乱斗初次登场时间为2016年7月13日。	
TB_DECKBUILDING_FIRSTCARDPLAYED	每当你使用一张牌时，复制该牌并洗入你的牌库。	
TB_DECKBUILDING_FIRSTENDTURN	将你的手牌洗回牌库，并重新抽牌。	
TB_DECKBUILDING_FIRSTPICKTHREE	为你的手牌挑选一张新的卡牌。	
TB_DECKBUILDING_STARTOFGAME	组建一副套牌去迎接挑战吧！祝你好运！	
TB_DECKBUILDING_STARTOFGAME_START	开始！	
TB_DECKRECIPE_MSG_DRUID	套牌模板：<b>玉莲战将</b>。	
TB_DECKRECIPE_MSG_HUNTER	套牌模板：<b>武装野兽</b>。	
TB_DECKRECIPE_MSG_MAGE	套牌模板：<b>暗金奥义</b>。	
TB_DECKRECIPE_MSG_PALADIN	套牌模板：<b>穷街陋市</b>。	
TB_DECKRECIPE_MSG_PRIEST	套牌模板：<b>藏龙出击</b>。	
TB_DECKRECIPE_MSG_ROGUE	套牌模板：<b>黑帆军团</b>。	
TB_DECKRECIPE_MSG_SHAMAN	套牌模板：<b>鱼人浪潮</b>。	
TB_DECKRECIPE_MSG_WARLOCK	套牌模板：<b>暗流涌动</b>。	
TB_DECKRECIPE_MSG_WARRIOR	套牌模板：<b>污手帝国</b>。	
TB_DECKRECIPE_OG_DRUID	利用德鲁伊独有的法术来产生法力水晶，从而在早期召唤出上古之神的仆从来碾压对手。	
TB_DECKRECIPE_OG_HUNTER	别担心，英雄。因为你的随从无论是生是死，都会助你一臂之力的。大胆地用你的随从和对方进行交换吧，你会赢得最终的胜利！	
TB_DECKRECIPE_OG_MAGE	尽情施展魔法吧！因为你用得越多，苏醒的尤格-萨隆就会越厉害！	
TB_DECKRECIPE_OG_PALADIN	用圣盾保护你的随从，使其免疫受到的第一次伤害，从而有效地进行持续作战！	
TB_DECKRECIPE_OG_PRIEST	为你的随从进行治疗，让他们能够活着看到实力恐怖的克苏恩降临于世！	
TB_DECKRECIPE_OG_ROGUE	尽管用你的随从与对手进行交换吧！他们中的大多数在死亡时会给予你特殊效果，所以牺牲也是值得的。	
TB_DECKRECIPE_OG_SHAMAN	召唤出尽可能多的随从，然后将其强化！经过强化后的随从绝对会让你之前的投资物超所值！	
TB_DECKRECIPE_OG_WARLOCK	用上古之神无穷无尽的爪牙来扩充你的部队，用小型的随从来淹没你的对手。	
TB_DECKRECIPE_OG_WARRIOR	控制场面，叠加护甲，在侍奉克苏恩的同时保护好自己。等到上古之神登场后，让你的对手灰飞烟灭。	
TB_DPROMO_2NDHERO	奶牛王	
TB_DPROMO_2NDHEROPOPUP	欢迎来到隐藏关卡！	
TB_DPROMO_COWKINGEMOTES	哞	
TB_FIREFEST_FIRST	迷你拉格纳罗斯每次烧死随从后就会提高\n攻击力！	
TB_FIREFEST_SECOND	打得不错！多献祭几个随从，就能获得特别的奖励！	
TB_GIFTEXCHANGE_GIFTSPAWNED	如果你这边没有大礼包，那一定在另一边。	
TB_GIFTEXCHANGE_GIFTSTOLEN	你领到了一份礼物！会是什么呢……	
TB_GIFTEXCHANGE_START	冬幕节快乐！好礼送不停！	
TB_LETHAL_NAME	成败在此一举	
TB_LETHALPUZZLES_FAILURE	再试一次吧！	
TB_LETHALPUZZLES_START	每一轮你都得击败对手…祝你好运！	
TB_LETHALPUZZLES_SUCCESS	你成功了！	
TB_MP_BOSS	装饰过的暴风城	
TB_MP_BOSS2	派对之所	
TB_MP_BOSS3	派对之都	
TB_MP_COOP_1STSPELL	噢糟糕，暗金教的家伙好像在酒里下了药…	
TB_MP_COOP_2NDSPELL	室内严禁燃放烟花爆竹！	
TB_MP_COOP_CRASHER_DISCARD	派对捣蛋鬼在玩家的手牌里闲得发慌，决定自行离开。	
TB_MP_COOP_ENDING	成功啦！感谢你能和我们一起庆祝猛犸年！	
TB_MP_COOP_FIRST_CRASHER	当心，那些家伙想毁掉派对！给他们点颜色\n瞧瞧！	
TB_MP_COOP_PINATA	你办到了，砸彩罐时间到！但是派对捣蛋鬼也开始躁动不安…	
TB_MP_COOP_TEXT_START	和其他玩家一起用英雄技能来装饰旅店。	
TB_MP_CROSSROADS	等等，那家伙是谁？	
TB_MP_CROSSROADS_CRASHER	他在这做什么？	
TB_MP_STORMWIND_SUCCESS	你成功了！还能继续打破记录吗？	
TB_PICKYOURFATE_BUILDAROUND_FIRSTFATE	命运的选择对双方玩家都会产生影响！	
TB_PICKYOURFATE_BUILDAROUND_NEWFATE	请记住，该加成只会对你产生影响。	
TB_PICKYOURFATE_BUILDAROUND_OPPONENT_FIRSTFATE	对手选择的命运也会对你产生影响！	
TB_PICKYOURFATE_BUILDAROUND_OPPONENTFATE	请记住，该加成只会对你的对手产生影响。	
TB_PICKYOURFATE_RANDOM_FIRSTFATE	命运的选择对双方玩家都会产生影响！	
TB_PICKYOURFATE_RANDOM_NEWFATE	你需要一个新的命运！	
TB_PICKYOURFATE_RANDOM_OPPONENTFATE	你的对手需要一个新的命运！	
TB_SHADOWTOWERS_ADJACENTMINIONS	在塔旁边的随从会获得<b>潜行</b>，且无法攻击。	
TB_SHADOWTOWERS_SHADOWSPAWNED	如果有一方没有塔了，就会为其召唤一座新的塔。	
TB_SHADOWTOWERS_SHADOWSPAWNEDNEXT	在拥有者的回合开始时，会替换掉遗失的塔。	
